80 40
0:0, 0:0, 0:0, 0:0, 0:0, 0:0, 0:0, 0:0, 0:0, 0:0, 0:0, 0:0, 0:0, 0:0, 0:0, 0:0,
0:0, 0:0, 0:0, 0:0, 0:0, 0:0, 0:0, 0:0, 0:0, 0:0, 0:0, 0:0, 0:0, 0:0, 0:0, 0:0,
0:0, 0:0, 0:0, 0:0, 0:0, 0:0, 0:0, 0:0, 0:0, 0:0, 0:0, 0:0, 0:0, 0:0, 0:0, 0:0,
0:0, 0:0, 0:0, 0:0, 0:0, 0:0, 0:0, 0:0, 0:0, 0:0, 0:0, 0:0, 0:0, 0:0, 0:0, 0:0,
0:0, 0:0, 0:0, 0:0, 0:0, 0:0, 0:0, 0:0, 0:0, 0:0, 0:0, 0:0, 0:0, 0:0, 0:0, 0:0,
0:0, 0:0, 0:0, 0:0, 0:0, 0:0, 0:0, 0:0, 0:0, 0:0, 0:0, 0:0, 0:0, 0:0, 0:0, 0:0,
0:0, 0:0, 0:0, 0:0, 0:0, 0:0, 0:0, 0:0, 0:0, 0:0, 0:0, 0:0, 0:0, 0:0, 0:0, 0:0,
0:0, 0:0, 0:0, 0:0, 0:0, 0:0, 0:0, 0:0, 0:0, 0:0, 0:0, 0:0, 0:0, 0:0, 0:0, 0:0,
0:0, 0:0, 0:0, 0:0, 0:0, 0:0, 0:0, 0:0, 0:0, 0:0, 0:0, 0:0, 0:0, 0:0, 0:0, 0:0,
0:0, 0:0, 0:0, 0:0, 0:0, 0:0, 0:0, 0:0, 0:0, 0:0, 0:0, 0:0, 0:0, 0:0, 0:0, 0:0,
0:0, 0:0, 0:0, 0:0, 0:0, 0:0, 0:0, 0:0, 0:0, 0:0, 0:0, 0:0, 0:0, 0:0, 0:0, 0:0,
0:0, 0:0, 0:0, 0:0, 0:0, 0:0, 0:0, 0:0, 0:0, 0:0, 0:0, 0:0, 0:0, 0:0, 0:0, 0:0,
0:0, 0:0, 0:0, 0:0, 0:0, 0:0, 0:0, 0:0, 0:0, 0:0, 0:0, 0:0, 0:0, 0:0, 0:0, 0:0,
0:0, 0:0, 0:0, 0:0, 0:0, 0:0, 0:0, 0:0, 0:0, 0:0, 0:0, 0:0, 0:0, 0:0, 0:0, 0:0,
0:0, 0:0, 0:0, 0:0, 0:0, 0:0, 0:0, 0:0, 0:0, 0:0, 0:0, 0:0, 0:0, 0:0, 0:0, 0:0,
0:0, 0:0, 0:0, 0:0, 0:0, 0:0, 0:0, 0:0, 0:0, 0:0, 0:0, 0:0, 0:0, 0:0, 0:0, 0:0,
0:0, 0:0, 0:0, 0:0, 0:0, 0:0, 0:0, 0:0, 0:0, 0:0, 0:0, 0:0, 0:0, 0:0, 0:0, 0:0,
0:0, 0:0, 0:0, 0:0, 0:0, 0:0, 0:0, 0:0, 0:0, 0:0, 0:0, 0:0, 0:0, 0:0, 0:0, 0:0,
0:0, 0:0, 0:0, 0:0, 0:0, 0:0, 0:0, 0:0, 0:0, 0:0, 0:0, 0:0, 0:0, 0:0, 0:0, 0:0,
0:0, 0:0, 0:0, 0:0, 0:0, 0:0, 0:0, 0:0, 0:0, 0:0, 0:0, 0:0, 0:0, 0:0, 0:0, 0:0,
0:0, 0:0, 0:0, 0:0, 0:0, 0:0, 0:0, 0:0, 0:0, 0:0, 0:0, 0:0, 0:0, 0:0, 0:0, 0:0,
0:0, 0:0, 0:0, 0:0, 0:0, 0:0, 0:0, 0:0, 0:0, 0:0, 0:0, 0:0, 0:0, 0:0, 0:0, 0:0,
0:0, 0:0, 0:0, 0:0, 0:0, 0:0, 0:0, 0:0, 0:0, 0:0, 0:0, 0:0, 0:0, 0:0, 0:0, 0:0,
0:0, 0:0, 0:0, 0:0, 0:0, 0:0, 0:0, 0:0, 0:0, 0:0, 0:0, 0:0, 0:0, 0:0, 0:0, 0:0,
0:0, 0:0, 0:0, 0:0, 0:0, 0:0, 0:0, 0:0, 0:0, 0:0, 0:0, 0:0, 0:0, 0:0, 0:0, 0:0,
0:0, 0:0, 0:0, 0:0, 0:0, 0:0, 0:0, 0:0, 0:0, 0:0, 0:0, 0:0, 0:0, 0:0, 0:0, 0:0,
0:0, 0:0, 0:0, 0:0, 0:0, 0:0, 0:0, 0:0, 0:0, 0:0, 0:0, 0:0, 0:0, 0:0, 0:0, 0:0,
0:0, 0:0, 0:0, 0:0, 0:0, 0:0, 0:0, 0:0, 0:0, 0:0, 0:0, 0:0, 0:0, 0:0, 0:0, 0:0,
0:0, 0:0, 0:0, 0:0, 0:0, 0:0, 0:0, 0:0, 0:0, 0:0, 0:0, 0:0, 0:0, 0:0, 0:0, 0:0,
0:0, 0:0, 0:0, 0:0, 0:0, 0:0, 0:0, 0:0, 0:0, 0:0, 0:0, 0:0, 0:0, 0:0, 0:0, 0:0,
8:0, 8:0, 8:0, 8:0, 8:0, 8:0, 8:0, 8:0, 8:0, 8:0, 8:0, 8:0, 8:0, 8:0, 8:0, 8:0,
8:0, 8:0, 8:0, 8:0, 8:0, 8:0, 8:0, 0:0, 0:0, 0:0, 0:0, 0:0, 0:0, 0:0, 0:0, 0:0,
0:0, 0:0, 0:0, 0:0, 0:0, 0:0, 0:0, 0:0, 0:0, 0:0, 0:0, 0:0, 0:0, 0:0, 0:0, 0:0,
0:0, 0:0, 0:0, 0:0, 0:0, 0:0, 0:0, 0:0, 0:0, 0:0, 0:0, 0:0, 0:0, 0:0, 0:0, 0:0,
0:0, 0:0, 0:0, 0:0, 0:0, 0:0, 0:0, 0:0, 0:0, 0:0, 0:0, 0:0, 0:0, 0:0, 0:0, 0:0,
8:10, 9:10, 0:0, 0:0, 0:0, 0:0, 0:0, 0:0, 0:0, 0:0, 0:0, 0:0, 0:0, 0:0, 0:0,
0:0, 0:0, 0:0, 0:0, 0:0, 0:0, 0:0, 8:0, 0:0, 0:0, 0:0, 0:0, 0:0, 0:0, 0:0, 0:0,
0:0, 0:0, 0:0, 0:0, 0:0, 0:0, 0:0, 0:0, 0:0, 0:0, 0:0, 0:0, 0:0, 0:0, 0:0, 0:0,
0:0, 0:0, 0:0, 0:0, 0:0, 0:0, 0:0, 0:0, 0:0, 0:0, 0:0, 0:0, 0:0, 0:0, 0:0, 0:0,
0:0, 0:0, 0:0, 0:0, 0:0, 0:0, 0:0, 0:0, 0:0, 0:0, 0:0, 0:0, 0:0, 0:0, 0:0, 0:0,
0:0, 8:0, 8:0, 0:0, 0:0, 0:0, 0:0, 0:0, 0:0, 0:0, 0:0, 0:0, 0:0, 0:0, 0:0, 0:0,
0:0, 0:0, 0:0, 0:0, 0:0, 0:0, 0:0, 8:0, 0:0, 0:0, 0:0, 0:0, 0:0, 0:0, 0:0, 0:0,
0:0, 0:0, 0:0, 0:0, 0:0, 0:0, 0:0, 0:0, 0:0, 0:0, 0:0, 0:0, 0:0, 0:0, 0:0, 0:0,
0:0, 0:0, 0:0, 0:0, 0:0, 0:0, 0:0, 0:0, 0:0, 0:0, 0:0, 0:0, 0:0, 0:0, 0:0, 0:0,
0:0, 0:0, 0:0, 0:0, 0:0, 0:0, 0:0, 0:0, 0:0, 0:0, 0:0, 0:0, 0:0, 0:0, 0:0, 0:0,
0:0, 8:10, 9:10, 0:0, 0:0, 0:0, 0:0, 0:0, 0:0, 0:0, 0:0, 0:0, 0:0, 0:0, 5:2,
6:2, 7:2, 0:0, 0:0, 0:0, 0:0, 0:0, 0:0, 8:0, 0:0, 0:0, 0:0, 0:0, 0:0, 0:0, 0:0,
0:0, 0:0, 0:0, 0:0, 0:0, 0:0, 0:0, 0:0, 0:0, 0:0, 0:0, 0:0, 0:0, 0:0, 0:0, 0:0,
0:0, 0:0, 0:0, 0:0, 0:0, 0:0, 0:0, 0:0, 0:0, 0:0, 0:0, 0:0, 0:0, 0:0, 0:0, 0:0,
0:0, 0:0, 0:0, 0:0, 0:0, 0:0, 0:0, 0:0, 0:0, 0:0, 0:0, 0:0, 0:0, 0:0, 0:0, 0:0,
0:0, 0:0, 8:0, 8:0, 0:0, 0:0, 5:2, 6:2, 7:2, 0:0, 0:0, 0:0, 0:0, 0:0, 0:0, 5:3,
6:3, 7:3, 0:0, 0:0, 0:0, 0:0, 0:0, 0:0, 8:0, 8:0, 8:0, 8:0, 8:0, 8:0, 8:0, 8:0,
8:0, 8:0, 8:0, 8:0, 8:0, 8:0, 8:0, 8:0, 8:0, 8:0, 8:0, 8:0, 8:0, 8:0, 8:0, 8:0,
8:0, 8:0, 8:0, 8:0, 8:0, 8:0, 8:0, 8:0, 8:0, 8:0, 8:0, 8:0, 8:0, 8:0, 8:0, 8:0,
8:0, 8:0, 8:0, 8:0, 8:0, 8:0, 8:0, 8:0, 8:0, 8:0, 8:0, 8:0, 8:0, 8:0, 8:0, 0:0,
0:0, 0:0, 8:10, 9:10, 0:0, 0:0, 5:3, 6:3, 7:3, 0:0, 0:0, 0:0, 0:0, 0:0, 0:0,
0:0, 0:0, 0:0, 0:0, 0:0, 0:0, 0:0, 0:0, 0:0, 0:0, 0:0, 0:0, 0:0, 0:0, 0:0, 0:0,
0:0, 0:0, 0:0, 0:0, 0:0, 0:0, 0:0, 0:0, 0:0, 0:0, 0:0, 6:5, 0:0, 0:0, 0:0, 0:0,
0:0, 0:0, 0:0, 0:0, 0:0, 0:0, 0:0, 0:0, 0:0, 0:0, 0:0, 0:0, 0:0, 0:0, 0:0, 0:0,
0:0, 0:0, 0:0, 0:0, 0:0, 0:0, 0:0, 0:0, 0:0, 0:0, 0:0, 0:0, 0:0, 0:0, 0:0, 8:0,
0:0, 0:0, 0:0, 8:0, 8:0, 0:0, 0:0, 0:0, 0:0, 0:0, 0:0, 0:0, 0:0, 0:0, 0:0, 0:0,
0:0, 0:0, 0:0, 0:0, 0:0, 0:0, 0:0, 0:0, 0:0, 0:0, 0:0, 0:0, 0:0, 0:0, 0:0, 0:0,
0:0, 0:0, 0:0, 0:0, 0:0, 0:0, 0:0, 0:0, 0:0, 0:0, 0:0, 0:8, 1:8, 2:8, 0:0, 0:0,
0:0, 0:0, 0:0, 0:0, 0:0, 0:0, 0:0, 0:0, 0:0, 0:0, 0:0, 0:0, 0:0, 0:0, 0:0, 0:0,
0:0, 0:0, 0:0, 0:0, 0:0, 0:0, 0:0, 0:0, 0:0, 0:0, 0:0, 0:0, 0:0, 0:0, 0:0, 8:0,
0:0, 0:0, 0:0, 8:10, 9:10, 0:0, 0:0, 0:0, 0:0, 0:0, 0:0, 0:0, 0:0, 0:0, 0:0,
0:0, 0:0, 0:0, 0:0, 0:0, 0:0, 0:0, 0:0, 0:0, 0:0, 0:0, 0:0, 0:0, 0:0, 0:0, 0:0,
0:0, 0:0, 0:0, 0:0, 0:0, 0:0, 0:0, 0:0, 0:0, 0:0, 0:0, 0:0, 0:9, 1:9, 2:9, 0:0,
0:0, 0:0, 0:0, 0:0, 0:0, 0:0, 0:0, 0:0, 0:0, 0:0, 0:0, 0:0, 0:0, 0:0, 0:0, 0:0,
0:0, 0:0, 0:0, 0:0, 0:0, 0:0, 0:0, 0:0, 0:0, 0:0, 0:0, 0:0, 0:0, 0:0, 0:0, 0:0,
8:0, 8:0, 8:0, 8:0, 8:0, 8:0, 0:0, 0:0, 0:0, 0:0, 0:0, 0:0, 0:0, 0:0, 0:0, 0:0,
0:0, 0:0, 0:0, 0:0, 0:0, 0:0, 0:0, 0:0, 0:0, 0:0, 0:0, 0:0, 0:0, 0:0, 0:0, 0:0,
0:0, 0:0, 0:0, 0:0, 0:0, 0:0, 0:0, 0:0, 0:0, 0:0, 0:8, 1:8, 2:8, 0:0, 0:0, 0:0,
0:0, 0:0, 0:0, 0:0, 0:0, 0:0, 0:0, 0:0, 0:0, 0:0, 0:0, 0:0, 0:0, 0:0, 0:0, 0:0,
0:0, 0:0, 0:0, 0:0, 0:0, 0:0, 0:0, 0:0, 0:0, 0:0, 0:0, 0:0, 0:0, 0:0, 0:0, 0:0,
0:0, 5:2, 6:2, 7:2, 8:10, 9:10, 0:0, 0:0, 0:0, 0:0, 0:0, 0:0, 0:0, 0:0, 0:0,
0:0, 0:0, 0:0, 0:0, 0:0, 0:0, 0:0, 0:0, 0:0, 0:0, 0:0, 0:0, 0:0, 0:0, 0:0, 0:0,
0:0, 0:0, 0:0, 0:0, 0:0, 0:0, 0:0, 0:0, 0:0, 0:0, 0:0, 0:9, 1:9, 2:9, 0:0, 0:0,
0:0, 0:0, 0:8, 1:8, 2:8, 0:0, 0:0, 0:0, 0:0, 0:0, 0:0, 0:0, 0:0, 0:0, 0:0, 0:0,
0:0, 0:0, 0:0, 0:0, 0:0, 0:0, 0:0, 0:0, 0:0, 0:0, 0:0, 0:0, 0:0, 0:0, 0:0, 0:0,
0:0, 0:0, 5:3, 6:3, 7:3, 8:0, 8:0, 0:0, 0:0, 0:0, 0:0, 0:0, 0:0, 0:0, 0:0, 0:0,
0:0, 13:4, 14:4, 15:4, 16:4, 17:4, 0:0, 0:0, 0:0, 0:0, 0:0, 0:0, 0:0, 0:0, 0:0,
0:0, 0:0, 0:0, 5:2, 6:2, 7:2, 0:0, 0:0, 0:0, 0:0, 0:0, 0:0, 0:0, 0:0, 0:8, 1:8,
2:8, 0:0, 0:0, 0:9, 1:9, 2:9, 0:0, 0:0, 0:0, 0:0, 0:0, 0:0, 0:0, 0:0, 0:0, 0:0,
0:0, 0:0, 0:8, 1:8, 2:8, 0:0, 0:0, 0:0, 0:0, 0:0, 0:0, 0:0, 0:0, 0:0, 0:0, 0:0,
0:0, 0:0, 0:0, 5:2, 6:2, 7:2, 8:10, 9:10, 0:0, 0:0, 0:0, 0:0, 0:0, 0:0, 0:0,
0:0, 0:0, 0:0, 13:5, 14:5, 15:5, 16:5, 17:5, 0:0, 0:0, 0:0, 0:0, 0:0, 0:0, 0:0,
0:0, 0:0, 0:0, 0:0, 0:0, 5:3, 6:3, 7:3, 0:0, 0:0, 0:0, 0:0, 0:0, 0:0, 0:0, 0:0,
0:9, 1:9, 2:9, 0:0, 0:0, 0:0, 0:0, 0:0, 0:0, 0:0, 0:0, 0:0, 0:0, 0:0, 0:0, 0:0,
0:0, 0:0, 0:0, 0:0, 0:9, 1:9, 2:9, 0:0, 0:0, 0:0, 0:0, 0:0, 0:0, 0:0, 0:0, 0:0,
0:0, 0:0, 0:0, 0:0, 0:0, 5:3, 6:3, 7:3, 8:0, 8:0, 0:0, 0:0, 0:0, 0:0, 0:0, 0:0,
0:0, 0:0, 0:0, 0:0, 13:6, 14:6, 15:6, 16:6, 17:6, 0:0, 0:0, 0:0, 0:0, 0:0, 0:0,
0:0, 0:0, 0:0, 0:0, 0:0, 0:0, 0:0, 0:0, 0:0, 0:0, 0:0, 0:0, 0:0, 0:0, 0:0, 0:8,
1:8, 2:8, 0:0, 0:0, 0:0, 0:0, 0:0, 0:0, 0:0, 0:0, 0:0, 0:0, 0:0, 0:0, 0:0, 0:0,
0:0, 0:0, 0:0, 0:0, 0:0, 0:0, 0:0, 0:0, 0:0, 0:0, 0:0, 0:0, 0:0, 0:0, 0:0, 0:0,
0:0, 0:0, 0:0, 0:0, 0:0, 0:0, 5:2, 6:2, 7:2, 8:10, 9:10, 0:0, 0:0, 0:0, 0:0,
0:0, 0:0, 0:0, 0:0, 0:0, 0:0, 13:7, 14:7, 15:7, 16:7, 17:7, 0:0, 0:0, 0:0, 0:0,
0:0, 0:0, 0:0, 0:0, 0:0, 0:0, 0:0, 0:0, 0:0, 0:0, 0:0, 0:0, 0:0, 0:0, 0:0, 0:0,
0:0, 0:9, 1:9, 2:9, 0:0, 0:0, 0:0, 0:0, 0:0, 0:0, 0:0, 0:0, 0:0, 0:0, 0:8, 1:8,
2:8, 0:0, 0:0, 0:0, 0:0, 0:0, 0:0, 0:0, 0:0, 0:0, 0:0, 0:0, 0:0, 0:0, 0:0, 0:0,
0:0, 0:0, 0:0, 0:0, 0:0, 0:0, 0:0, 0:0, 5:3, 6:3, 7:3, 8:0, 8:0, 0:0, 0:0, 0:0,
0:0, 0:0, 0:0, 0:0, 0:0, 0:0, 0:0, 0:0, 0:0, 0:0, 0:0, 7:5, 0:0, 0:0, 0:0, 0:0,
0:0, 0:0, 0:0, 0:0, 0:0, 0:0, 0:0, 0:0, 0:0, 0:0, 0:0, 0:0, 0:0, 0:0, 0:0, 0:0,
0:0, 0:0, 0:0, 0:8, 1:8, 2:8, 0:0, 0:0, 0:0, 0:0, 0:0, 0:0, 0:0, 0:0, 0:9, 1:9,
2:9, 0:0, 0:0, 0:0, 0:0, 0:0, 0:0, 0:0, 0:0, 0:0, 0:0, 0:0, 0:0, 0:0, 0:0, 0:0,
0:0, 0:0, 0:0, 0:0, 0:0, 0:0, 0:0, 0:0, 5:2, 6:2, 7:2, 8:10, 9:10, 0:0, 0:0,
0:0, 0:0, 0:0, 0:0, 0:0, 0:0, 0:0, 0:0, 0:0, 0:0, 0:0, 0:0, 0:0, 0:0, 0:0, 0:0,
0:0, 0:0, 5:2, 6:2, 7:2, 0:0, 0:0, 0:0, 0:0, 0:0, 0:0, 0:0, 0:0, 0:0, 0:0, 0:0,
0:0, 0:0, 0:0, 0:0, 0:9, 1:9, 2:9, 0:0, 0:0, 0:0, 0:0, 0:0, 0:0, 0:0, 0:0, 0:0,
0:0, 0:0, 0:0, 0:0, 0:0, 0:0, 0:0, 0:0, 0:0, 0:0, 0:0, 0:0, 0:0, 0:0, 0:0, 0:0,
0:0, 0:0, 0:0, 0:0, 0:0, 0:0, 0:0, 0:0, 0:0, 5:3, 6:3, 7:3, 8:0, 8:0, 0:0, 0:0,
0:0, 0:0, 0:0, 0:0, 0:0, 0:0, 0:0, 0:0, 0:0, 0:0, 0:0, 0:0, 0:0, 0:0, 0:0, 0:0,
0:0, 0:0, 5:3, 6:3, 7:3, 0:0, 0:0, 0:0, 0:0, 0:0, 0:0, 0:0, 0:0, 0:0, 0:0, 0:0,
0:0, 0:0, 5:2, 6:2, 7:2, 0:0, 0:0, 0:0, 0:0, 0:0, 0:0, 0:0, 0:0, 0:0, 0:0, 0:0,
0:0, 0:0, 0:0, 0:0, 0:0, 0:0, 0:0, 0:8, 1:8, 2:8, 0:0, 0:0, 0:0, 8:4, 9:4,
10:4, 11:4, 12:4, 0:0, 0:0, 0:0, 0:0, 0:0, 0:0, 0:0, 5:2, 6:2, 7:2, 8:10, 9:10,
0:0, 0:0, 0:0, 0:0, 0:0, 0:0, 0:0, 0:0, 0:0, 11:10, 0:0, 0:0, 0:0, 0:0, 0:0,
11:10, 0:0, 0:0, 0:0, 0:0, 0:0, 0:0, 0:0, 0:0, 0:0, 0:0, 0:0, 0:0, 0:0, 0:0,
0:0, 0:0, 0:0, 0:0, 0:0, 0:0, 5:3, 6:3, 7:3, 0:0, 0:0, 0:0, 0:0, 0:0, 0:0, 0:8,
1:8, 2:8, 0:0, 0:0, 0:0, 0:0, 0:0, 0:0, 0:0, 0:0, 0:0, 0:9, 1:9, 2:9, 0:0, 0:0,
0:0, 8:5, 9:5, 10:5, 11:5, 12:5, 0:0, 0:0, 0:0, 0:0, 0:0, 0:0, 0:0, 5:3, 6:3,
7:3, 8:0, 8:0, 0:0, 0:0, 0:0, 0:0, 0:0, 0:0, 0:0, 0:0, 0:0, 0:0, 0:0, 0:0, 0:0,
0:0, 0:0, 0:0, 0:0, 0:0, 0:0, 0:0, 0:0, 0:0, 0:0, 0:0, 0:0, 0:0, 0:0, 0:0, 0:0,
0:0, 0:0, 0:0, 0:0, 0:0, 0:0, 0:0, 0:0, 8:0, 0:0, 0:0, 0:0, 0:0, 0:0, 0:0, 0:0,
0:9, 1:9, 2:9, 0:0, 0:0, 0:0, 0:0, 0:0, 0:0, 0:0, 0:0, 0:0, 0:0, 0:0, 0:0, 0:0,
0:0, 7:5, 8:6, 9:6, 10:6, 11:6, 12:6, 0:0, 0:0, 0:0, 0:0, 0:0, 0:0, 0:0, 5:2,
6:2, 7:2, 8:10, 9:10, 0:0, 0:0, 5:2, 6:2, 7:2, 0:0, 0:0, 0:0, 0:0, 0:0, 0:0,
0:0, 0:0, 0:0, 0:0, 0:0, 0:0, 0:0, 0:0, 0:0, 0:0, 0:0, 0:0, 0:0, 0:0, 0:0, 0:0,
0:0, 0:0, 0:0, 0:0, 0:0, 0:0, 0:0, 0:0, 0:0, 0:0, 0:0, 0:0, 0:0, 0:0, 0:0, 0:0,
0:0, 0:0, 0:0, 0:0, 0:0, 0:0, 0:0, 0:0, 0:0, 0:0, 0:0, 0:0, 0:0, 0:0, 0:0, 0:0,
0:0, 0:0, 0:0, 0:0, 8:7, 9:7, 10:7, 11:7, 12:7, 0:0, 0:0, 0:0, 0:0, 0:0, 0:0,
0:0, 5:3, 6:3, 7:3, 8:0, 8:0, 0:0, 0:0, 5:3, 6:3, 7:3, 0:0, 0:0, 0:0, 0:0, 0:0,
0:0, 0:0, 0:0, 0:0, 0:0, 0:0, 0:0, 0:0, 0:0, 0:0, 0:0, 0:0, 0:0, 0:0, 0:0, 0:0,
0:0, 0:0, 0:0, 0:0, 0:0, 0:0, 0:0, 0:0, 0:0, 0:0, 0:10, 1:10, 0:0, 0:0, 0:0,
0:0, 0:0, 0:0, 0:0, 0:0, 0:0, 0:0, 0:0, 0:0, 0:8, 1:8, 2:8, 0:0, 0:0, 0:0, 0:0,
0:0, 0:0, 0:0, 11:10, 0:0, 0:0, 0:0, 0:0, 0:0, 10:9, 0:0, 0:0, 0:0, 0:0, 0:0,
0:0, 0:0, 0:0, 5:2, 6:2, 7:2, 8:10, 9:10, 0:0, 0:0, 0:0, 0:0, 0:0, 0:0, 0:0,
0:0, 0:0, 0:0, 0:0, 0:0, 0:0, 0:0, 0:0, 0:0, 0:0, 0:0, 0:0, 0:0, 0:0, 0:0, 0:0,
0:0, 0:0, 0:0, 0:0, 0:0, 0:0, 0:0, 0:0, 0:0, 0:0, 0:0, 0:0, 0:0, 0:0, 0:8, 1:8,
2:8, 0:0, 0:0, 0:0, 0:0, 0:0, 0:0, 0:0, 0:0, 0:0, 0:0, 0:9, 1:9, 2:9, 0:0, 0:0,
0:0, 0:0, 0:0, 0:0, 0:0, 0:0, 0:0, 0:0, 0:0, 0:0, 0:0, 0:0, 0:0, 0:0, 0:0, 0:0,
0:0, 0:0, 0:0, 0:0, 5:3, 6:3, 7:3, 8:0, 8:0, 0:0, 0:0, 5:2, 6:2, 7:2, 0:0, 0:0,
0:0, 0:0, 0:0, 0:0, 0:0, 0:0, 0:0, 0:0, 0:0, 0:0, 0:0, 0:0, 0:0, 0:0, 0:0, 0:0,
0:0, 0:0, 0:0, 0:0, 0:0, 0:0, 0:0, 0:0, 0:0, 0:0, 0:0, 0:0, 0:0, 0:0, 0:9, 1:9,
2:9, 0:0, 0:0, 0:0, 0:0, 0:0, 0:0, 0:0, 0:0, 0:0, 0:0, 0:0, 0:0, 0:0, 0:0, 0:0,
0:0, 0:0, 0:0, 0:0, 0:0, 0:0, 0:0, 0:0, 0:0, 0:0, 0:0, 0:0, 0:0, 0:0, 0:0, 0:0,
0:0, 0:0, 0:0, 0:0, 5:2, 6:2, 7:2, 8:10, 9:10, 0:0, 0:0, 5:3, 6:3, 7:3, 0:0,
0:0, 0:0, 0:0, 0:0, 0:0, 0:0, 0:0, 0:0, 0:0, 0:0, 0:0, 0:0, 0:0, 0:0, 0:0, 0:0,
0:0, 0:0, 0:0, 0:0, 5:2, 6:2, 7:2, 0:0, 0:0, 0:0, 0:0, 0:0, 0:0, 0:0, 0:8, 1:8,
2:8, 0:0, 0:0, 0:0, 0:0, 0:0, 0:0, 0:0, 0:0, 0:0, 0:0, 0:0, 0:0, 0:0, 0:0, 0:0,
0:0, 0:0, 0:0, 0:0, 0:0, 0:0, 0:0, 0:0, 0:0, 0:0, 0:0, 0:0, 0:0, 0:0, 0:0, 0:0,
0:0, 0:0, 0:0, 0:0, 0:0, 5:3, 6:3, 7:3, 8:0, 8:0, 0:0, 0:0, 0:0, 0:0, 0:0, 0:0,
0:0, 0:0, 0:0, 0:0, 0:0, 0:0, 0:0, 0:0, 0:0, 0:0, 0:0, 0:0, 0:0, 0:0, 0:0, 0:0,
0:0, 0:0, 0:0, 0:0, 5:3, 6:3, 7:3, 0:0, 0:0, 0:0, 0:0, 0:0, 0:0, 0:0, 0:9, 1:9,
2:9, 0:0, 0:0, 0:0, 0:0, 0:0, 0:0, 0:0, 0:0, 0:0, 0:0, 0:0, 0:0, 0:0, 0:0, 0:0,
0:0, 0:0, 0:0, 0:0, 0:0, 0:0, 0:0, 0:0, 0:0, 0:0, 0:0, 0:0, 0:0, 0:0, 0:0, 0:0,
0:0, 0:0, 0:0, 0:0, 0:0, 5:2, 6:2, 7:2, 8:10, 9:10, 0:0, 0:0, 5:2, 6:2, 7:2,
0:0, 0:0, 0:0, 0:0, 0:0, 0:0, 0:0, 0:0, 0:0, 0:0, 0:0, 0:0, 0:0, 0:0, 0:0, 0:0,
0:0, 0:0, 0:0, 0:0, 0:0, 0:0, 0:0, 0:0, 0:0, 0:0, 0:0, 0:0, 0:0, 0:0, 0:0, 0:8,
1:8, 2:8, 0:0, 0:0, 0:0, 0:0, 0:0, 0:0, 0:0, 0:0, 0:0, 0:0, 0:0, 0:0, 0:0, 0:0,
0:0, 0:0, 0:0, 0:0, 0:0, 0:0, 0:0, 0:0, 0:0, 0:0, 0:0, 0:0, 0:0, 0:0, 0:0, 0:0,
0:0, 0:0, 0:0, 0:0, 0:0, 0:0, 5:3, 6:3, 7:3, 8:0, 8:0, 0:0, 0:0, 5:3, 6:3, 7:3,
0:0, 0:0, 0:0, 0:0, 0:0, 0:0, 0:0, 0:0, 0:0, 0:0, 0:0, 0:0, 0:0, 0:0, 0:0, 0:0,
0:0, 0:0, 0:0, 0:0, 0:0, 0:0, 0:0, 0:0, 0:0, 0:0, 0:0, 0:0, 0:0, 0:0, 0:0, 0:9,
1:9, 2:9, 0:0, 0:0, 0:0, 0:0, 0:0, 0:0, 0:8, 1:8, 2:8, 0:0, 0:0, 0:0, 0:0, 0:0,
0:0, 0:0, 0:0, 0:0, 0:0, 0:0, 0:0, 0:0, 0:0, 0:0, 0:0, 0:0, 0:0, 0:0, 0:0, 0:0,
0:0, 0:0, 0:0, 0:0, 0:0, 0:0, 5:2, 6:2, 7:2, 8:10, 9:10, 0:0, 0:0, 0:0, 0:0,
0:0, 0:0, 0:0, 0:0, 0:0, 0:0, 0:0, 0:0, 0:0, 0:0, 0:0, 0:0, 0:0, 0:0, 0:0, 0:0,
0:0, 0:0, 0:0, 0:0, 0:0, 0:0, 0:0, 0:0, 0:0, 0:0, 0:0, 0:0, 0:0, 0:0, 0:0, 0:8,
1:8, 2:8, 0:0, 0:0, 0:0, 0:0, 0:0, 0:0, 0:0, 0:9, 1:9, 2:9, 0:0, 0:0, 0:0, 0:0,
0:0, 0:0, 0:0, 0:0, 0:0, 0:8, 1:8, 2:8, 0:0, 0:0, 0:0, 0:0, 0:0, 0:0, 0:0, 0:0,
0:0, 0:0, 0:0, 0:0, 0:0, 0:0, 0:0, 5:3, 6:3, 7:3, 8:0, 8:0, 0:0, 0:0, 5:2, 6:2,
7:2, 5:2, 6:2, 7:2, 5:2, 6:2, 7:2, 5:2, 6:2, 7:2, 5:2, 6:2, 7:2, 0:0, 0:0, 0:0,
0:0, 0:0, 0:0, 0:0, 0:0, 0:0, 0:0, 0:0, 0:0, 0:0, 0:0, 0:0, 0:0, 0:0, 0:0, 0:9,
1:9, 2:9, 0:0, 0:0, 0:0, 0:0, 0:0, 0:0, 0:0, 0:0, 0:0, 0:0, 0:0, 0:0, 0:0, 0:0,
0:0, 0:0, 0:0, 0:0, 0:0, 0:9, 1:9, 2:9, 0:0, 0:0, 0:0, 0:0, 0:0, 0:0, 0:0, 0:0,
0:0, 0:0, 0:0, 0:0, 0:0, 0:0, 0:0, 5:2, 6:2, 7:2, 8:10, 9:10, 0:0, 0:0, 5:3,
6:3, 7:3, 5:3, 6:3, 7:3, 5:3, 6:3, 7:3, 5:3, 6:3, 7:3, 5:3, 6:3, 7:3, 0:0, 0:0,
0:0, 0:0, 0:0, 0:0, 0:0, 0:0, 0:0, 0:0, 0:0, 0:0, 0:0, 0:0, 0:0, 0:0, 0:0, 0:0,
0:0, 0:8, 1:8, 2:8, 0:0, 0:0, 0:0, 0:0, 0:0, 0:0, 0:0, 0:0, 0:0, 0:0, 0:0, 0:0,
0:0, 0:0, 0:0, 0:0, 0:0, 0:0, 0:0, 0:0, 0:0, 0:0, 0:0, 0:0, 0:0, 0:0, 0:0, 0:0,
0:0, 0:0, 0:0, 0:0, 0:0, 0:0, 0:0, 0:0, 5:3, 6:3, 7:3, 8:0, 8:0, 0:0, 0:0, 0:0,
0:0, 0:0, 0:0, 0:0, 0:0, 0:0, 0:0, 0:0, 0:0, 0:0, 0:0, 0:0, 0:0, 0:0, 0:0, 0:0,
0:0, 0:0, 0:0, 0:0, 0:0, 0:0, 0:0, 0:0, 0:0, 0:0, 0:0, 0:0, 0:0, 0:0, 0:0, 0:0,
0:0, 0:9, 1:9, 2:9, 0:0, 0:0, 0:0, 0:0, 0:0, 0:0, 0:0, 0:0, 0:0, 0:0, 0:0, 0:0,
0:0, 0:0, 0:0, 0:0, 0:0, 0:0, 0:0, 0:0, 0:0, 0:0, 0:0, 0:0, 0:0, 0:0, 0:0, 0:0,
0:0, 0:0, 0:0, 0:0, 0:0, 0:0, 0:0, 0:0, 5:2, 6:2, 7:2, 8:10, 9:10, 0:0, 0:0,
0:0, 0:0, 0:0, 0:0, 0:0, 0:0, 0:0, 0:0, 0:0, 0:0, 0:0, 0:0, 0:0, 0:0, 0:0, 0:0,
0:0, 0:0, 0:0, 0:0, 0:0, 0:0, 0:0, 0:0, 0:0, 0:0, 0:0, 0:0, 0:0, 0:0, 0:0, 0:0,
0:0, 0:0, 0:0, 0:0, 6:5, 0:0, 0:0, 0:0, 0:0, 0:0, 0:0, 0:0, 0:0, 0:0, 0:0, 0:0,
0:0, 0:0, 0:0, 0:0, 0:0, 0:0, 0:0, 0:0, 0:0, 0:0, 0:0, 0:0, 0:0, 0:0, 0:0, 0:0,
0:0, 0:0, 0:0, 0:0, 0:0, 0:0, 0:0, 0:0, 0:0, 5:3, 6:3, 7:3, 8:0, 8:0, 5:2, 6:2,
7:2, 5:2, 6:2, 7:2, 5:2, 6:2, 7:2, 5:2, 6:2, 7:2, 5:2, 6:2, 7:2, 5:2, 6:2, 7:2,
5:2, 6:2, 7:2, 5:2, 6:2, 7:2, 5:2, 6:2, 7:2, 5:2, 6:2, 7:2, 5:2, 6:2, 7:2, 5:2,
6:2, 7:2, 5:2, 6:2, 7:2, 5:2, 6:2, 7:2, 5:2, 6:2, 7:2, 5:2, 6:2, 7:2, 5:2, 6:2,
7:2, 5:2, 6:2, 7:2, 5:2, 6:2, 7:2, 5:2, 6:2, 7:2, 5:2, 6:2, 7:2, 5:2, 6:2, 7:2,
5:2, 6:2, 7:2, 5:2, 6:2, 7:2, 5:2, 6:2, 7:2, 5:2, 6:2, 7:2, 8:10, 9:10, 5:3,
6:3, 7:3, 5:3, 6:3, 7:3, 5:3, 6:3, 7:3, 5:3, 6:3, 7:3, 5:3, 6:3, 7:3, 5:3, 6:3,
7:3, 5:3, 6:3, 7:3, 5:3, 6:3, 7:3, 5:3, 6:3, 7:3, 5:3, 6:3, 7:3, 5:3, 6:3, 7:3,
5:3, 6:3, 7:3, 5:3, 6:3, 7:3, 5:3, 6:3, 7:3, 5:3, 6:3, 7:3, 5:3, 6:3, 7:3, 5:3,
6:3, 7:3, 5:3, 6:3, 7:3, 5:3, 6:3, 7:3, 5:3, 6:3, 7:3, 5:3, 6:3, 7:3, 5:3, 6:3,
7:3, 5:3, 6:3, 7:3, 5:3, 6:3, 7:3, 5:3, 6:3, 7:3, 5:3, 6:3, 7:3
