80 40
0:0, 0:0, 0:0, 0:0, 0:0, 0:0, 0:0, 0:0, 0:0, 0:0, 0:0, 0:0, 0:0, 0:0, 0:0, 0:0, 0:0, 0:0, 0:0, 0:0, 0:0, 0:0, 0:0, 0:0, 0:0, 0:0,
0:0, 0:0, 0:0, 0:0, 0:0, 0:0, 0:0, 0:0, 0:0, 0:0, 0:0, 0:0, 0:0, 0:0, 0:0, 0:0, 0:0, 0:0, 0:0, 0:0, 0:0, 0:0, 0:0, 0:0, 0:0, 0:0,
0:0, 0:0, 0:0, 0:0, 0:0, 0:0, 0:0, 0:0, 0:0, 0:0, 0:0, 0:0, 0:0, 0:0, 0:0, 0:0, 0:0, 0:0, 0:0, 0:0, 0:0, 0:0, 0:0, 0:0, 0:0, 0:0,
0:0, 0:0, 0:0, 0:0, 0:0, 0:0, 0:0, 0:0, 0:0, 0:0, 0:0, 0:0, 0:0, 0:0, 0:0, 0:0, 0:0, 0:0, 0:0, 0:0, 0:0, 0:0, 0:0, 0:0, 0:0, 0:0,
0:0, 0:0, 0:0, 0:0, 0:0, 0:0, 0:0, 0:0, 0:0, 0:0, 0:0, 0:0, 0:0, 0:0, 0:0, 0:0, 0:0, 0:0, 0:0, 0:0, 0:0, 0:0, 0:0, 0:0, 0:0, 0:0,
0:0, 0:0, 0:0, 0:0, 0:0, 0:0, 0:0, 0:0, 0:0, 0:0, 0:0, 0:0, 0:0, 0:0, 0:0, 0:0, 0:0, 0:0, 0:0, 0:0, 0:0, 0:0, 0:0, 0:0, 0:0, 0:0,
0:0, 0:0, 0:0, 0:0, 0:0, 0:0, 0:0, 0:0, 0:0, 0:0, 0:0, 0:0, 0:0, 0:0, 0:0, 0:0, 0:0, 0:0, 0:0, 0:0, 0:0, 0:0, 0:0, 0:0, 0:0, 0:0,
0:0, 0:0, 0:0, 0:0, 0:0, 0:0, 0:0, 0:0, 0:0, 0:0, 0:0, 0:0, 0:0, 0:0, 0:0, 0:0, 0:0, 0:0, 0:0, 0:0, 0:0, 0:0, 0:0, 0:0, 0:0, 0:0,
0:0, 0:0, 0:0, 0:0, 0:0, 0:0, 0:0, 0:0, 0:0, 0:0, 0:0, 0:0, 0:0, 0:0, 0:0, 0:0, 0:0, 0:0, 0:0, 0:0, 0:0, 0:0, 0:0, 0:0, 0:0, 0:0,
0:0, 0:0, 0:0, 0:0, 0:0, 0:0, 0:0, 0:0, 0:0, 0:0, 0:0, 0:0, 0:0, 0:0, 0:0, 0:0, 0:0, 0:0, 0:0, 0:0, 0:0, 0:0, 0:0, 0:0, 0:0, 0:0,
0:0, 0:0, 0:0, 0:0, 0:0, 0:0, 0:0, 0:0, 0:0, 0:0, 0:0, 0:0, 0:0, 0:0, 0:0, 0:0, 0:0, 0:0, 0:0, 0:0, 0:0, 0:0, 0:0, 0:0, 0:0, 0:0,
0:0, 0:0, 0:0, 0:0, 0:0, 0:0, 0:0, 0:0, 0:0, 0:0, 0:0, 0:0, 0:0, 0:0, 0:0, 0:0, 0:0, 0:0, 0:0, 0:0, 0:0, 0:0, 0:0, 0:0, 0:0, 0:0,
0:0, 0:0, 0:0, 0:0, 0:0, 0:0, 0:0, 0:0, 0:0, 0:0, 0:0, 0:0, 0:0, 0:0, 0:0, 0:0, 0:0, 0:0, 0:0, 0:0, 0:0, 0:0, 0:0, 0:0, 0:0, 0:0,
0:0, 0:0, 0:0, 0:0, 0:0, 0:0, 0:0, 0:0, 0:0, 0:0, 0:0, 0:0, 0:0, 0:0, 0:0, 0:0, 0:0, 0:0, 0:0, 0:0, 0:0, 0:0, 0:0, 0:0, 0:0, 0:0,
0:0, 0:0, 0:0, 0:0, 0:0, 0:0, 0:0, 0:0, 0:0, 0:0, 0:0, 0:0, 0:0, 0:0, 0:0, 0:0, 0:0, 0:0, 0:0, 0:0, 0:0, 0:0, 0:0, 0:0, 0:0, 0:0,
0:0, 0:0, 0:0, 0:0, 0:0, 0:0, 0:0, 0:0, 0:0, 0:0, 0:0, 0:0, 0:0, 0:0, 0:0, 0:0, 0:0, 0:0, 0:0, 0:0, 0:0, 0:0, 0:0, 0:0, 0:0, 0:0,
0:0, 0:0, 0:0, 0:0, 0:0, 0:0, 0:0, 0:0, 0:0, 0:0, 0:0, 0:0, 0:0, 0:0, 0:0, 0:0, 0:0, 0:0, 0:0, 0:0, 0:0, 0:0, 0:0, 0:0, 0:0, 0:0,
0:0, 0:0, 0:0, 0:0, 0:0, 0:0, 0:0, 0:0, 0:0, 0:0, 0:0, 0:0, 0:0, 0:0, 0:0, 0:0, 0:0, 0:0, 0:0, 0:0, 0:0, 0:0, 0:0, 0:0, 0:0, 0:0,
0:0, 0:0, 0:0, 0:0, 0:0, 0:0, 0:0, 0:0, 0:0, 0:0, 0:0, 0:0, 1:5, 1:5, 1:5, 1:5, 1:5, 1:5, 1:5, 1:5, 1:5, 1:5, 1:5,
1:5, 1:5, 1:5, 1:5, 1:5, 1:5, 1:5, 1:5, 1:5, 1:5, 1:5, 17:8, 0:0, 0:0, 0:0, 0:0, 0:0, 0:0, 0:0, 0:0, 0:0, 0:0,
0:0, 0:0, 0:0, 0:0, 0:0, 0:0, 0:0, 0:0, 0:0, 0:0, 0:0, 0:0, 0:0, 0:0, 0:0, 0:0, 0:0, 0:0, 0:0, 0:0, 0:0, 0:0, 0:0, 0:0, 0:0, 0:0,
0:0, 0:0, 0:0, 0:0, 0:0, 0:0, 0:0, 0:0, 0:0, 0:0, 0:0, 0:0, 0:0, 0:0, 0:0, 0:0, 0:0, 0:0, 0:0, 0:0, 0:0, 0:0, 0:0, 0:0, 0:0, 0:0,
0:0, 0:0, 0:0, 0:0, 0:0, 0:0, 0:0, 0:0, 0:0, 0:0, 0:0, 0:0, 0:0, 0:0, 0:0, 0:0, 0:0, 0:4, 0:0, 0:0, 0:0, 0:0, 0:0, 0:0, 0:0, 0:0,
0:0, 0:0, 0:0, 0:0, 0:0, 0:0, 0:0, 0:0, 0:0, 0:0, 0:0, 0:0, 0:0, 0:0, 0:0, 0:0, 0:0, 0:0, 0:0, 0:0, 0:0, 0:0, 0:0, 0:0, 0:0, 0:0,
0:0, 0:0, 0:0, 0:0, 0:0, 0:0, 0:0, 0:0, 0:0, 0:0, 0:0, 0:0, 0:0, 0:0, 0:0, 0:0, 0:0, 0:0, 0:0, 0:0, 0:0, 0:0, 0:0, 0:0, 0:0, 0:0,
0:0, 0:0, 0:0, 0:0, 0:0, 0:0, 0:0, 0:0, 0:0, 0:0, 0:0, 0:0, 0:0, 0:0, 0:0, 0:0, 0:0, 0:0, 0:0, 0:4, 0:0, 0:0, 0:0, 0:0, 0:0, 0:0,
0:0, 0:0, 0:0, 0:0, 0:0, 0:0, 0:0, 0:0, 0:0, 0:0, 0:0, 0:0, 0:0, 0:0, 0:0, 0:0, 0:0, 0:0, 0:0, 0:0, 0:0, 0:0, 0:0, 0:0, 0:0, 0:0,
0:0, 0:0, 0:0, 0:0, 0:0, 0:0, 0:0, 0:0, 0:0, 0:0, 0:0, 0:0, 0:0, 0:0, 0:0, 0:0, 0:0, 0:0, 0:0, 0:0, 0:0, 0:0, 0:0, 0:0, 0:0, 0:0,
0:0, 0:0, 0:0, 0:0, 0:0, 0:0, 0:0, 0:0, 4:5, 0:0, 0:0, 0:0, 0:0, 0:0, 0:0, 0:0, 0:0, 0:0, 0:0, 5:5, 0:0, 0:4, 0:0, 0:0, 0:0,
0:0, 0:0, 0:0, 0:0, 0:0, 0:0, 0:0, 0:0, 0:0, 0:0, 0:0, 0:0, 0:0, 0:0, 0:0, 0:0, 0:0, 0:0, 0:0, 0:0, 0:0, 0:0, 0:0, 0:0, 0:0, 0:0,
0:0, 0:0, 0:0, 0:0, 0:0, 0:0, 0:0, 0:0, 0:0, 0:0, 0:0, 0:0, 0:0, 0:0, 0:0, 0:0, 0:0, 0:0, 0:0, 0:0, 0:0, 0:0, 0:0, 0:0, 0:0, 0:0,
0:0, 0:0, 0:0, 0:0, 0:0, 0:0, 0:0, 0:0, 0:0, 0:0, 0:0, 0:0, 0:0, 0:0, 0:0, 0:0, 0:0, 0:0, 0:0, 0:0, 0:0, 0:0, 0:0, 0:0, 0:5, 1:5,
1:5, 1:5, 1:5, 1:5, 1:5, 1:5, 1:5, 1:5, 1:5, 1:5, 1:5, 1:5, 1:5, 1:5, 1:5, 1:5, 1:5, 1:5, 1:5, 1:5,
1:5, 1:5, 1:5, 1:5, 1:5, 1:5, 1:5, 1:5, 1:5, 1:5, 1:5, 1:5, 1:5, 1:5, 1:5, 1:5, 1:5, 1:5, 1:5, 1:5,
1:5, 1:5, 1:5, 1:5, 1:5, 1:5, 1:5, 1:5, 1:5, 1:5, 1:5, 1:5, 17:8, 0:0, 0:0, 0:0, 0:0, 0:0, 0:0, 0:0, 0:0, 0:0,
0:0, 0:0, 0:0, 0:0, 0:0, 0:0, 0:0, 0:0, 0:0, 0:0, 0:0, 0:0, 0:0, 0:0, 0:0, 0:0, 0:0, 0:0, 0:0, 0:0, 0:0, 0:0, 0:0, 0:0, 0:0, 0:0,
0:0, 0:0, 0:0, 0:0, 0:0, 0:0, 0:0, 0:0, 0:0, 0:0, 0:0, 0:0, 0:0, 0:0, 0:0, 0:0, 0:0, 0:0, 0:0, 0:0, 0:0, 0:0, 0:0, 0:0, 0:0, 5:5,
0:0, 0:0, 0:0, 0:0, 0:0, 0:0, 0:0, 0:0, 0:0, 0:0, 0:0, 0:0, 0:0, 0:0, 0:0, 0:0, 0:0, 0:0, 0:4, 0:0, 0:0, 0:0, 0:0, 0:0, 0:0, 0:0,
0:0, 0:0, 0:0, 4:1, 4:1, 4:1, 4:1, 0:0, 0:0, 0:0, 0:0, 0:0, 3:3, 0:0, 0:0, 0:0, 0:0, 0:0, 0:0, 0:0, 4:5, 0:0, 0:0, 0:0,
0:0, 0:0, 0:0, 0:0, 0:0, 0:0, 0:0, 4:5, 0:0, 0:0, 0:0, 0:0, 0:0, 0:0, 0:0, 0:0, 0:0, 0:0, 0:0, 0:0, 0:0, 0:0, 0:0, 0:0, 0:0, 5:5,
0:0, 0:0, 0:0, 0:0, 0:0, 0:0, 0:0, 0:0, 5:5, 0:0, 0:0, 0:0, 0:0, 0:0, 0:0, 0:0, 0:0, 0:0, 0:0, 0:0, 0:0, 0:0, 0:4, 0:0, 0:0, 0:0,
0:0, 0:0, 0:0, 0:0, 0:0, 0:0, 0:0, 4:1, 4:1, 4:1, 4:1, 0:0, 0:0, 0:0, 0:0, 0:0, 0:0, 0:0, 0:0, 0:0, 0:0, 3:5, 3:3, 0:0,
4:3, 0:0, 0:0, 0:0, 0:0, 0:0, 0:0, 0:0, 3:3, 4:3, 0:0, 0:0, 0:0, 0:0, 0:0, 0:0, 0:0, 0:0, 0:0, 0:0, 0:0, 0:0, 0:0, 0:0, 0:0,
0:0, 0:0, 0:0, 0:0, 0:0, 3:5, 4:3, 5:5, 5:5, 0:0, 0:0, 0:0, 0:0, 0:0, 0:0, 0:0, 0:0, 0:0, 0:0, 4:5, 0:0, 0:0, 0:0, 0:0, 0:0,
0:0, 0:0, 0:5, 1:5, 1:5, 1:5, 0:0, 0:0, 0:0, 0:0, 0:0, 0:0, 0:0, 4:1, 4:1, 4:1, 4:1, 0:0, 0:0, 0:0, 0:0, 0:0, 0:0, 0:0,
0:0, 0:0, 0:0, 0:0, 0:0, 0:0, 3:3, 0:0, 0:0, 0:0, 0:0, 0:0, 0:0, 0:0, 0:0, 0:0, 4:3, 0:0, 0:0, 0:0, 0:0, 0:0, 0:0, 3:3, 0:0,
0:0, 0:0, 0:0, 0:0, 0:0, 0:0, 0:0, 0:0, 0:0, 0:0, 0:0, 5:5, 3:3, 0:0, 3:3, 0:0, 0:0, 0:0, 0:0, 0:0, 0:0, 0:0, 0:0, 0:0, 0:0,
0:0, 3:5, 0:0, 0:0, 0:0, 0:0, 0:0, 0:0, 0:0, 0:0, 0:0, 0:0, 0:0, 0:0, 0:0, 0:0, 0:0, 4:5, 0:0, 0:0, 0:0, 0:0, 0:0, 0:0, 0:0, 0:0,
0:0, 0:0, 0:0, 0:0, 0:0, 0:0, 0:0, 0:0, 0:0, 0:0, 0:0, 0:0, 0:0, 0:0, 0:0, 0:0, 0:0, 0:0, 0:0, 0:0, 0:0, 0:0, 0:0, 3:5, 0:0, 0:0,
0:0, 0:0, 0:0, 0:0, 0:0, 0:0, 0:0, 0:0, 0:0, 0:0, 0:0, 0:0, 0:0, 0:0, 0:0, 0:0, 0:0, 0:0, 0:0, 0:0, 0:0, 0:0, 0:0, 0:0, 0:0, 0:0,
0:0, 0:0, 0:0, 0:0, 0:0, 0:0, 0:0, 0:0, 0:0, 0:0, 0:0, 0:0, 0:0, 0:0, 0:0, 0:0, 0:0, 0:0, 0:0, 0:0, 0:0, 0:0, 0:0, 0:0, 0:0, 0:0,
0:0, 0:0, 0:0, 0:0, 0:0, 0:0, 0:0, 5:5, 0:0, 0:0, 0:0, 0:0, 0:0, 4:3, 0:0, 0:0, 0:0, 0:0, 0:0, 0:0, 0:0, 0:0, 0:0, 0:0, 0:0, 0:0,
0:0, 0:0, 0:0, 0:0, 0:0, 0:0, 0:0, 0:0, 0:0, 0:0, 0:0, 0:0, 0:0, 0:0, 0:0, 0:0, 0:0, 0:0, 0:0, 0:0, 0:0, 0:0, 0:0, 0:0, 0:0, 0:0,
0:0, 0:0, 0:0, 0:0, 0:0, 0:0, 0:0, 0:0, 0:0, 0:0, 0:0, 0:0, 0:0, 0:0, 0:0, 0:0, 0:0, 0:0, 0:0, 0:0, 0:0, 0:0, 0:0, 0:0, 0:0, 0:0,
0:0, 0:0, 0:0, 0:0, 0:0, 0:0, 0:0, 0:0, 0:0, 0:0, 0:0, 0:0, 0:0, 0:0, 0:0, 0:0, 0:0, 0:0, 0:0, 0:0, 0:0, 0:0, 0:0, 0:0, 0:0, 0:0,
0:0, 0:0, 0:0, 0:0, 0:0, 0:0, 0:0, 0:0, 0:0, 0:0, 0:0, 0:0, 0:0, 0:0, 0:0, 0:0, 0:0, 0:0, 0:0, 0:0, 0:0, 0:0, 0:0, 0:0, 0:0, 0:0,
0:0, 0:0, 0:0, 3:3, 0:0, 0:0, 0:0, 0:0, 0:0, 0:0, 0:0, 0:0, 4:3, 0:0, 0:0, 0:0, 0:0, 0:0, 0:0, 0:0, 0:0, 0:0, 0:0, 0:0, 0:0, 0:0,
5:5, 0:0, 0:0, 0:0, 0:0, 0:0, 0:0, 0:0, 0:0, 0:0, 0:0, 0:0, 0:0, 0:0, 0:0, 0:0, 0:0, 0:0, 0:0, 0:0, 0:0, 0:0, 0:0, 0:0, 0:0, 0:0,
0:0, 3:3, 0:0, 0:0, 0:0, 0:0, 0:0, 0:0, 0:0, 0:0, 0:0, 0:0, 0:0, 0:0, 0:0, 0:0, 0:0, 0:0, 0:0, 0:0, 0:0, 0:0, 0:0, 0:0, 0:0, 0:0,
0:0, 0:0, 0:0, 0:0, 0:0, 0:0, 0:0, 0:0, 0:0, 0:0, 0:0, 0:0, 0:0, 0:0, 0:0, 0:0, 0:0, 0:0, 0:0, 0:0, 0:0, 0:0, 0:0, 0:0, 0:0, 0:0,
3:5, 0:0, 0:0, 0:0, 0:0, 0:0, 0:0, 1:1, 0:0, 3:1, 0:0, 0:0, 0:0, 0:0, 0:0, 0:0, 0:0, 0:0, 0:0, 0:0, 0:0, 0:0, 0:0, 0:0, 0:0,
0:0, 0:0, 0:0, 0:0, 0:0, 0:0, 0:0, 0:0, 0:0, 0:0, 0:0, 0:0, 0:0, 0:0, 0:0, 0:0, 0:0, 0:0, 0:0, 0:0, 0:0, 0:0, 0:0, 0:0, 0:0, 0:0,
0:0, 0:0, 0:0, 0:0, 0:0, 0:0, 0:0, 0:0, 0:0, 0:0, 0:0, 0:0, 0:0, 0:0, 0:0, 0:0, 0:0, 0:0, 0:0, 0:0, 0:0, 0:0, 0:0, 0:0, 0:0, 0:0,
0:0, 0:0, 0:0, 0:0, 0:0, 0:0, 0:0, 0:0, 0:0, 0:0, 1:1, 0:0, 3:1, 0:0, 0:0, 0:0, 0:0, 0:0, 0:0, 0:0, 0:0, 0:0, 0:0, 0:0, 0:0, 0:0,
0:0, 0:0, 0:0, 0:0, 0:0, 0:0, 0:0, 0:0, 0:0, 0:0, 0:0, 0:0, 0:0, 0:0, 0:0, 0:0, 0:0, 3:3, 0:0, 0:0, 0:0, 0:0, 0:0, 0:0, 0:0, 0:0,
4:1, 4:1, 4:1, 0:0, 0:0, 0:0, 0:0, 0:0, 0:0, 0:0, 0:0, 0:0, 0:0, 0:0, 0:0, 0:0, 0:0, 0:0, 0:0, 0:0, 3:3, 0:0, 0:0, 0:0, 0:0,
0:0, 0:0, 0:0, 0:0, 0:0, 0:0, 0:0, 0:0, 0:0, 0:0, 0:0, 0:0, 0:0, 1:1, 0:0, 3:1, 0:0, 0:0, 0:0, 0:0, 0:0, 0:0, 0:0, 0:0, 0:0, 0:0,
0:0, 0:0, 0:0, 0:0, 0:0, 0:0, 5:5, 0:0, 0:0, 0:0, 0:0, 0:0, 0:0, 0:0, 0:0, 0:0, 0:0, 0:0, 0:0, 0:0, 0:0, 0:0, 0:0, 0:0, 0:0, 0:0,
0:0, 0:0, 0:0, 4:1, 4:1, 4:1, 0:0, 0:0, 0:0, 0:0, 0:0, 0:0, 0:0, 0:0, 0:0, 0:0, 0:0, 0:0, 0:0, 0:0, 0:0, 0:0, 0:0, 0:0, 0:0,
0:0, 0:0, 0:0, 0:0, 0:0, 0:0, 0:0, 0:0, 0:0, 0:0, 0:0, 0:0, 0:0, 0:0, 0:0, 0:0, 1:1, 0:0, 3:1, 0:0, 0:0, 0:0, 0:0, 0:0, 0:0, 0:0,
0:0, 0:0, 0:0, 0:0, 0:0, 4:3, 0:0, 0:0, 0:0, 0:0, 0:0, 0:0, 0:0, 0:0, 0:0, 0:0, 0:0, 0:0, 0:0, 0:0, 0:0, 0:0, 0:0, 0:0, 0:0, 0:0,
0:0, 0:0, 0:0, 0:0, 0:0, 0:0, 4:1, 4:1, 4:1, 0:0, 0:0, 0:0, 0:0, 0:0, 0:0, 0:0, 0:0, 0:0, 0:0, 0:0, 0:0, 0:0, 0:0, 0:0, 0:0,
0:0, 0:0, 0:0, 0:0, 0:0, 0:0, 0:0, 0:0, 0:0, 0:0, 0:0, 0:0, 0:0, 0:0, 0:0, 0:0, 0:0, 0:0, 0:0, 1:1, 0:0, 3:1, 0:0, 0:0, 0:0, 0:0,
0:0, 0:0, 0:0, 0:0, 0:0, 0:0, 0:0, 0:0, 0:0, 0:0, 0:0, 0:0, 0:0, 0:0, 0:0, 0:0, 0:0, 0:0, 0:0, 0:0, 0:0, 0:0, 0:0, 0:0, 0:0, 7:4,
0:0, 0:0, 0:0, 0:0, 0:0, 0:0, 0:0, 0:0, 0:0, 0:0, 0:0, 0:0, 0:0, 0:0, 0:0, 0:0, 0:0, 0:0, 0:0, 0:0, 0:0, 0:0, 0:0, 0:0, 0:0, 0:0,
0:0, 0:0, 0:0, 0:0, 0:0, 0:0, 0:0, 0:0, 0:0, 0:0, 0:0, 0:0, 0:0, 0:0, 0:0, 0:0, 0:0, 0:0, 0:0, 0:0, 0:0, 1:1, 0:0, 3:1, 0:0, 0:0,
0:0, 0:0, 0:0, 0:0, 0:0, 0:0, 0:0, 0:0, 0:0, 0:0, 0:0, 1:0, 2:0, 2:0, 2:0, 2:0, 2:0, 2:0, 2:0, 2:0, 2:0, 2:0, 2:0, 3:0, 0:0, 0:0,
0:0, 0:0, 0:0, 0:0, 0:0, 0:0, 0:0, 0:0, 0:0, 0:0, 0:0, 0:0, 0:0, 0:0, 0:0, 0:0, 0:0, 0:0, 0:0, 0:0, 0:0, 0:0, 0:0, 0:0, 0:0, 0:0,
0:0, 0:0, 0:0, 0:0, 0:0, 0:0, 0:0, 0:0, 0:0, 0:0, 0:0, 0:0, 0:0, 0:0, 0:0, 0:0, 0:0, 0:0, 0:0, 0:0, 0:0, 0:0, 0:0, 1:1, 0:0, 3:1,
0:0, 0:0, 7:4, 0:0, 0:0, 0:0, 0:0, 0:0, 0:0, 0:0, 0:0, 0:0, 0:0, 1:2, 2:2, 2:2, 2:2, 2:2, 2:2, 2:2, 2:2, 2:2, 2:2,
2:2, 2:2, 3:2, 0:0, 0:0, 0:0, 0:0, 0:0, 0:0, 0:0, 0:0, 0:0, 0:0, 0:0, 0:0, 0:0, 0:0, 0:0, 0:0, 0:0, 0:0, 0:0, 0:0, 0:0, 0:0,
0:0, 0:0, 0:0, 0:0, 0:0, 0:0, 0:0, 0:0, 0:0, 3:5, 0:0, 0:0, 0:0, 0:0, 0:0, 0:0, 0:0, 0:0, 0:0, 0:0, 0:0, 0:0, 0:0, 0:0, 0:0, 0:0,
0:0, 0:0, 0:0, 1:2, 2:2, 3:2, 0:0, 0:0, 0:0, 0:0, 0:0, 0:0, 0:0, 0:0, 0:0, 0:0, 7:4, 0:0, 0:0, 0:0, 0:0, 0:0, 0:0, 0:0, 0:0,
0:0, 0:0, 0:0, 0:0, 0:0, 0:0, 0:0, 0:0, 0:0, 0:0, 0:0, 0:0, 0:0, 0:0, 0:0, 0:0, 0:0, 0:0, 0:0, 0:0, 0:0, 0:0, 0:0, 0:0, 0:0, 0:0,
0:0, 0:0, 0:0, 0:0, 0:0, 0:0, 0:0, 0:0, 0:0, 0:0, 0:0, 0:0, 0:0, 0:0, 0:0, 0:0, 0:0, 0:0, 0:0, 0:0, 0:0, 0:0, 4:3, 0:0, 0:0, 0:0,
0:0, 0:0, 0:0, 0:0, 0:0, 0:0, 0:0, 0:0, 0:0, 0:0, 0:0, 0:0, 0:0, 0:0, 7:4, 0:0, 0:0, 0:0, 0:0, 0:0, 0:0, 0:0, 0:0, 0:0, 0:0, 0:0,
0:0, 0:0, 0:0, 0:0, 0:0, 0:0, 0:0, 0:0, 0:0, 4:1, 4:1, 4:1, 0:0, 0:0, 0:0, 7:4, 0:0, 0:0, 0:0, 0:0, 0:0, 0:0, 0:0, 0:0, 1:0,
2:0, 2:0, 2:0, 2:0, 2:0, 2:0, 2:0, 2:0, 2:0, 2:0, 3:0, 0:0, 0:0, 5:5, 0:0, 0:0, 0:0, 7:4, 0:0, 0:0, 0:0, 0:0, 0:0, 0:0, 0:0, 0:0,
0:0, 0:0, 0:0, 0:0, 0:0, 0:0, 4:1, 4:1, 4:1, 4:1, 4:1, 4:1, 4:1, 4:1, 0:0, 0:0, 0:0, 0:0, 0:0, 0:0, 4:5, 0:0, 0:0,
0:0, 0:0, 0:0, 0:0, 0:0, 0:0, 0:0, 0:0, 0:0, 0:0, 0:0, 0:0, 0:0, 0:0, 0:0, 4:1, 4:1, 4:1, 0:0, 0:0, 0:0, 0:0, 0:0, 0:0, 0:0,
0:0, 0:0, 0:0, 0:0, 0:0, 1:2, 2:2, 2:2, 2:2, 2:2, 2:2, 2:2, 2:2, 2:2, 2:2, 2:2, 3:2, 0:0, 0:0, 0:0, 0:0, 0:0,
0:0, 0:0, 0:0, 0:0, 0:0, 0:0, 0:0, 0:0, 0:0, 0:0, 0:0, 0:0, 0:0, 0:0, 0:0, 0:0, 4:1, 4:1, 4:1, 4:1, 4:1, 4:1, 4:1, 4:1,
0:0, 0:0, 0:0, 0:0, 0:0, 0:0, 0:0, 0:0, 0:0, 0:0, 0:0, 0:0, 0:0, 0:0, 0:0, 4:3, 3:5, 0:0, 0:0, 0:0, 0:0, 0:0, 0:0, 0:0, 4:1,
4:1, 4:1, 0:0, 0:0, 0:0, 0:0, 0:0, 0:0, 0:0, 0:0, 0:0, 7:4, 0:0, 0:0, 0:0, 0:0, 0:0, 0:0, 0:0, 0:0, 0:0, 0:0, 0:0, 0:0, 0:0,
0:0, 0:0, 0:0, 0:0, 0:0, 0:0, 0:0, 0:0, 0:0, 0:0, 0:0, 0:0, 0:0, 0:0, 0:0, 0:0, 0:0, 0:0, 0:0, 0:0, 0:0, 0:0, 4:1, 4:1, 4:1,
4:1, 4:1, 4:1, 4:1, 4:1, 0:0, 7:4, 0:0, 0:0, 0:0, 0:0, 0:0, 0:0, 0:0, 0:0, 0:0, 0:0, 0:0, 0:0, 0:0, 0:0, 5:5, 0:0, 0:0,
0:0, 0:0, 0:0, 0:0, 0:0, 4:1, 4:1, 4:1, 0:0, 0:0, 0:0, 0:0, 0:0, 0:0, 0:0, 0:0, 0:0, 0:0, 0:0, 0:0, 0:0, 0:0, 0:0, 0:0, 0:0,
0:0, 0:0, 0:0, 0:0, 0:0, 0:0, 0:0, 0:0, 0:0, 4:5, 0:0, 0:0, 0:0, 0:0, 0:0, 0:0, 0:0, 0:0, 0:0, 0:0, 0:0, 0:0, 0:0, 0:0, 0:0, 0:0,
0:0, 0:0, 4:1, 4:1, 4:1, 4:1, 4:1, 4:1, 4:1, 4:1, 0:0, 0:0, 0:0, 0:0, 0:0, 0:0, 0:0, 0:0, 0:0, 0:0, 0:0, 0:0, 0:0, 0:0,
4:5, 5:5, 0:0, 0:0, 0:0, 0:0, 0:0, 0:0, 0:0, 0:0, 4:1, 4:1, 4:1, 0:0, 0:0, 0:0, 0:0, 0:0, 0:0, 0:0, 0:0, 4:5, 0:0, 0:0,
0:0, 0:0, 0:0, 0:0, 0:0, 0:0, 0:0, 0:0, 0:0, 0:0, 0:0, 0:0, 0:0, 0:0, 0:0, 0:0, 0:0, 0:0, 3:3, 0:0, 0:0, 0:0, 0:0, 0:0, 0:0, 0:0,
0:0, 0:0, 0:0, 0:0, 0:0, 0:0, 0:0, 0:0, 4:1, 4:1, 4:1, 4:1, 4:1, 4:1, 4:1, 4:1, 0:0, 0:0, 0:0, 0:0, 0:0, 0:0, 0:0, 0:0,
0:0, 0:0, 0:0, 0:0, 0:0, 0:0, 0:0, 0:0, 0:0, 0:0, 0:0, 0:0, 0:0, 0:0, 0:0, 0:0, 0:0, 0:0, 0:0, 0:0, 0:0, 0:0, 0:0, 0:0, 0:0, 0:0,
0:0, 0:0, 0:0, 0:0, 0:0, 0:0, 0:0, 0:0, 0:0, 0:0, 0:0, 0:0, 0:0, 0:0, 3:3, 0:0, 0:0, 0:0, 0:0, 0:0, 0:0, 0:0, 0:0, 0:0, 0:0, 0:0,
0:0, 0:0, 0:0, 0:0, 0:0, 0:0, 0:0, 0:0, 0:0, 0:0, 0:0, 0:0, 0:0, 0:0, 0:0, 0:0, 0:0, 0:0, 0:0, 0:0, 0:0, 0:0, 0:0, 0:0, 0:0, 0:0,
0:0, 0:0, 0:0, 0:0, 0:0, 0:0, 0:0, 0:0, 0:0, 0:0, 0:0, 0:0, 0:0, 0:0, 0:0, 0:0, 5:5, 0:0, 0:0, 0:0, 0:0, 0:0, 0:0, 0:0, 0:0, 0:0,
0:0, 0:0, 0:0, 0:0, 1:0, 3:0, 0:0, 0:0, 0:0, 0:0, 0:0, 0:0, 0:0, 0:0, 0:0, 0:0, 0:0, 0:0, 0:0, 0:0, 0:0, 0:0, 0:0, 0:0, 0:0, 0:0,
0:0, 0:0, 0:0, 0:0, 0:0, 0:0, 0:0, 0:0, 0:0, 0:0, 0:0, 0:0, 0:0, 0:0, 0:0, 0:0, 0:0, 0:0, 0:0, 0:0, 0:0, 0:0, 0:0, 0:0, 0:0, 0:0,
0:0, 0:0, 0:0, 0:0, 0:0, 0:0, 0:0, 0:0, 0:0, 0:0, 0:0, 0:0, 0:0, 0:0, 0:0, 0:0, 0:0, 0:0, 0:0, 0:0, 0:0, 0:0, 0:0, 0:0, 0:0, 0:0,
0:0, 0:0, 0:0, 0:0, 0:0, 0:0, 1:2, 3:2, 0:0, 0:0, 0:0, 0:0, 0:0, 0:0, 0:0, 0:0, 0:0, 0:0, 0:0, 0:0, 0:0, 0:0, 0:0, 0:0, 0:0,
4:3, 0:0, 0:0, 0:0, 0:0, 0:0, 0:0, 0:0, 0:0, 0:0, 3:3, 0:0, 0:0, 0:0, 0:0, 0:0, 0:0, 0:0, 0:0, 0:0, 0:0, 0:0, 0:0, 0:0, 0:0, 0:0,
0:0, 0:0, 0:0, 0:0, 0:0, 0:0, 0:0, 0:0, 0:0, 0:0, 0:0, 0:0, 0:0, 0:0, 0:0, 0:0, 0:0, 0:0, 0:0, 0:0, 0:0, 0:0, 0:0, 0:0, 0:0, 0:0,
0:0, 0:0, 0:0, 0:0, 0:0, 0:0, 0:0, 0:0, 0:0, 0:0, 0:0, 0:0, 0:0, 0:0, 0:0, 0:0, 0:0, 0:0, 0:0, 0:0, 0:0, 0:0, 0:0, 0:0, 0:0, 0:0,
0:0, 0:0, 0:0, 0:0, 0:0, 0:0, 0:0, 0:0, 0:0, 0:0, 0:0, 0:0, 0:0, 0:0, 0:0, 0:0, 0:0, 0:0, 0:0, 0:0, 0:0, 0:0, 0:0, 0:0, 0:0, 0:0,
0:0, 0:0, 0:0, 0:0, 0:0, 0:0, 0:0, 0:0, 0:0, 0:0, 0:0, 0:0, 0:0, 0:0, 0:0, 0:0, 0:0, 0:0, 0:0, 0:0, 0:0, 0:0, 0:0, 0:0, 0:0, 0:0,
0:0, 0:0, 0:0, 0:0, 0:0, 0:0, 0:0, 0:0, 0:0, 0:0, 0:0, 0:0, 0:0, 0:0, 0:0, 0:0, 0:0, 0:0, 0:0, 0:0, 0:0, 0:0, 0:0, 0:0, 0:0, 0:0,
0:0, 0:0, 0:0, 0:0, 0:0, 0:0, 0:0, 0:0, 0:0, 0:0, 0:0, 0:0, 0:0, 0:0, 0:0, 0:0, 0:0, 0:0, 0:0, 0:0, 0:0, 0:0, 0:0, 0:0, 0:0, 0:0,
0:0, 0:0, 0:0, 0:0, 0:0, 0:0, 0:0, 0:0, 0:0, 0:0, 0:0, 0:0, 0:0, 0:0, 0:0, 0:0, 0:0, 0:0, 0:0, 0:0, 0:0, 0:0, 0:0, 0:0, 0:0, 0:0,
0:0, 0:0, 0:0, 0:0, 0:0, 0:0, 0:0, 0:0, 0:0, 0:0, 0:0, 0:0, 0:0, 0:0, 0:0, 0:0, 0:0, 0:0, 0:0, 0:0, 0:0, 0:0, 0:0, 0:0, 0:0, 0:0,
0:0, 0:0, 0:0, 0:0, 0:0, 0:0, 0:0, 0:0, 0:0, 0:0, 0:0, 0:0, 0:0, 0:0, 0:0, 0:0, 0:0, 0:0, 0:0, 0:0, 0:0, 0:0, 0:0, 0:0, 0:0, 0:0,
0:0, 0:0, 0:0, 0:0, 0:0, 0:0, 0:0, 0:0, 0:0, 0:0, 0:0, 0:0, 0:0, 0:0, 0:0, 0:0, 0:0, 0:0, 0:0, 0:0, 0:0, 0:0, 0:0, 0:0, 0:0, 0:0,
0:0, 0:0, 0:0, 0:0, 0:0, 0:0, 0:0, 0:0, 0:0, 0:0, 0:0, 0:0, 0:0, 0:0, 0:0, 0:0, 0:0, 0:0, 0:0, 0:0, 0:0, 0:0, 0:0, 0:0, 0:0, 0:0,
0:0, 0:0, 0:0, 0:0, 0:0, 0:0, 0:0, 0:0, 0:0, 0:0, 0:0, 0:0, 0:0, 0:0, 0:0, 0:0, 0:0, 0:0, 0:0, 0:0, 0:0, 0:0, 0:0, 0:0, 0:0, 0:0,
0:0, 0:0, 0:0, 0:0, 0:0, 0:0, 0:0, 0:0, 0:0, 0:0, 0:0, 0:0, 0:0, 0:0, 0:0, 0:0, 0:0, 0:0, 0:0, 0:0, 0:0, 0:0, 0:0, 0:0, 0:0, 0:0,
0:0, 0:0, 0:0, 0:0, 0:0, 0:0, 0:0, 0:0, 0:0, 0:0, 0:0, 0:0, 0:0, 0:0, 0:0, 0:0, 0:0, 0:0, 0:0, 0:0, 0:0, 0:0, 0:0, 0:0, 0:0, 0:0,
0:0, 0:0, 0:0, 0:0, 0:0, 0:0, 0:0, 0:0, 0:0, 0:0, 0:0, 0:0, 0:0, 0:0, 0:0, 0:0, 0:0,
