80 40
0:0, 0:0, 0:0, 0:0, 0:0, 0:0, 0:0, 0:0, 0:0, 0:0, 0:0, 0:0, 0:0, 0:0, 0:0, 0:0,
0:0, 0:0, 0:0, 0:0, 0:0, 0:0, 0:0, 0:0, 0:0, 0:0, 0:0, 0:0, 0:0, 0:0, 0:0, 0:0,
0:0, 0:0, 0:0, 0:0, 0:0, 0:0, 0:0, 0:0, 0:0, 0:0, 0:0, 0:0, 0:0, 0:0, 0:0, 0:0,
0:0, 0:0, 0:0, 0:0, 0:0, 0:0, 0:0, 0:0, 0:0, 0:0, 0:0, 0:0, 0:0, 0:0, 0:0, 0:0,
0:0, 0:0, 0:0, 0:0, 0:0, 0:0, 0:0, 0:0, 0:0, 0:0, 0:0, 0:0, 0:0, 0:0, 0:0, 0:0,
0:0, 0:0, 0:0, 0:0, 0:0, 0:0, 0:0, 0:0, 0:0, 0:0, 0:0, 0:0, 0:0, 0:0, 0:0, 0:0,
0:0, 0:0, 0:0, 0:0, 0:0, 0:0, 0:0, 0:0, 0:0, 0:0, 0:0, 0:0, 0:0, 0:0, 0:0, 0:0,
0:0, 0:0, 0:0, 0:0, 0:0, 0:0, 0:0, 0:0, 0:0, 0:0, 0:0, 0:0, 0:0, 0:0, 0:0, 0:0,
0:0, 0:0, 0:0, 0:0, 0:0, 0:0, 0:0, 0:0, 0:0, 0:0, 0:0, 0:0, 0:0, 0:0, 0:0, 0:0,
0:0, 0:0, 0:0, 0:0, 0:0, 0:0, 0:0, 0:0, 0:0, 0:0, 0:0, 0:0, 0:0, 0:0, 0:0, 0:0,
0:0, 0:0, 0:0, 0:0, 0:0, 0:0, 0:0, 0:0, 0:0, 0:0, 0:0, 0:0, 0:0, 0:0, 0:0, 0:0,
0:0, 0:0, 0:0, 0:0, 0:0, 0:0, 0:0, 0:0, 0:0, 0:0, 0:0, 0:0, 0:0, 0:0, 0:0, 0:0,
0:0, 0:0, 0:0, 0:0, 0:0, 0:0, 0:0, 0:0, 0:0, 0:0, 0:0, 0:0, 0:0, 0:0, 0:0, 0:0,
0:0, 0:0, 0:0, 0:0, 0:0, 0:0, 0:0, 0:0, 0:0, 0:0, 0:0, 0:0, 0:0, 0:0, 0:0, 0:0,
0:0, 0:0, 0:0, 0:0, 0:0, 0:0, 0:0, 0:0, 0:0, 0:0, 0:0, 0:0, 0:0, 0:0, 0:0, 0:0,
0:0, 0:0, 0:0, 0:0, 0:0, 0:0, 0:0, 0:0, 0:0, 0:0, 0:0, 0:0, 0:0, 0:0, 0:0, 0:0,
0:0, 0:0, 0:0, 0:0, 0:0, 0:0, 0:0, 0:0, 0:0, 0:0, 0:0, 0:0, 0:0, 0:0, 0:0, 0:0,
0:0, 0:0, 0:0, 0:0, 0:0, 0:0, 0:0, 0:0, 0:0, 0:0, 0:0, 0:0, 0:0, 0:0, 0:0, 0:0,
0:0, 0:0, 0:0, 0:0, 0:0, 0:0, 0:0, 0:0, 0:0, 0:0, 0:0, 0:0, 0:0, 0:0, 0:0, 0:0,
0:0, 0:0, 0:0, 0:0, 0:0, 0:0, 0:0, 0:0, 0:0, 0:0, 0:0, 0:0, 0:0, 0:0, 0:0, 0:0,
0:0, 0:0, 0:0, 0:0, 0:0, 0:0, 0:0, 0:0, 0:0, 0:0, 0:0, 0:0, 0:0, 0:0, 0:0, 0:0,
0:0, 0:0, 0:0, 0:0, 0:0, 0:0, 0:0, 0:0, 0:0, 0:0, 0:0, 0:0, 0:0, 0:0, 0:0, 0:0,
0:0, 0:0, 0:0, 0:0, 0:0, 0:0, 0:0, 0:0, 0:0, 0:0, 0:0, 0:0, 0:0, 0:0, 0:0, 0:0,
0:0, 0:0, 0:0, 0:0, 0:0, 0:0, 0:0, 0:0, 0:0, 0:0, 0:0, 0:0, 0:0, 0:0, 0:0, 0:0,
0:0, 0:0, 0:0, 0:0, 0:0, 0:0, 0:0, 0:0, 0:0, 0:0, 0:0, 0:0, 0:0, 0:0, 0:0, 0:0,
8:8, 9:8, 0:0, 0:0, 0:0, 0:0, 0:0, 0:0, 0:0, 0:0, 0:0, 0:0, 0:0, 0:0, 0:0, 0:0,
0:0, 0:0, 0:0, 0:0, 0:0, 0:0, 0:0, 0:0, 0:0, 0:0, 0:0, 0:0, 0:0, 0:0, 0:0, 0:0,
0:0, 0:0, 0:0, 0:0, 0:0, 0:0, 0:0, 0:0, 0:0, 0:0, 0:0, 0:0, 0:0, 0:0, 0:0, 0:0,
0:0, 0:0, 0:0, 0:0, 0:0, 0:0, 0:0, 0:0, 0:0, 0:0, 0:0, 0:0, 0:0, 0:0, 0:0, 0:0,
0:0, 0:0, 0:0, 0:0, 0:0, 0:0, 0:0, 0:0, 0:0, 0:0, 0:0, 0:0, 0:0, 0:0, 0:0, 0:0,
8:9, 9:9, 0:0, 0:0, 0:0, 0:0, 0:0, 0:0, 0:0, 0:0, 0:0, 0:0, 0:0, 0:0, 0:0, 0:0,
0:0, 0:0, 0:0, 0:0, 0:0, 0:0, 0:0, 0:0, 0:0, 0:0, 0:0, 0:0, 0:0, 0:0, 0:0, 0:0,
0:0, 0:0, 0:0, 0:0, 0:0, 0:0, 0:0, 0:0, 0:0, 0:0, 0:0, 0:0, 0:0, 0:0, 0:0, 0:0,
0:0, 0:0, 0:0, 0:0, 0:0, 0:0, 0:0, 0:0, 0:0, 0:0, 0:0, 0:0, 0:0, 0:0, 0:0, 0:0,
0:0, 0:0, 0:0, 0:0, 0:0, 0:0, 0:0, 0:0, 0:0, 0:0, 0:0, 0:0, 0:0, 0:0, 0:0, 0:0,
8:8, 9:8, 0:0, 0:0, 0:0, 0:0, 0:0, 0:0, 0:0, 0:0, 0:0, 0:0, 0:0, 5:0, 6:0, 7:0,
0:0, 0:0, 0:0, 0:0, 0:0, 0:0, 0:0, 0:0, 0:0, 0:0, 0:0, 0:0, 0:0, 0:0, 0:0, 0:0,
0:0, 0:0, 0:0, 0:0, 0:0, 0:0, 0:0, 0:0, 0:0, 0:0, 0:0, 0:0, 0:0, 0:0, 0:0, 0:0,
0:0, 0:0, 0:0, 0:0, 0:0, 0:0, 0:0, 0:0, 0:0, 0:0, 0:0, 0:0, 0:0, 0:0, 0:0, 0:0,
0:0, 0:0, 0:0, 0:0, 0:0, 0:0, 0:0, 0:0, 0:0, 0:0, 0:0, 0:0, 0:0, 0:0, 0:0, 0:0,
8:9, 9:9, 0:0, 0:0, 5:0, 6:0, 7:0, 0:0, 0:0, 0:0, 0:0, 0:0, 0:0, 5:1, 6:1, 7:1,
0:0, 0:0, 0:0, 0:0, 0:0, 0:0, 0:0, 0:0, 0:0, 0:0, 0:0, 0:0, 0:0, 0:0, 0:0, 0:0,
0:0, 0:0, 0:0, 0:0, 0:0, 0:0, 0:0, 0:0, 0:0, 0:0, 0:0, 0:0, 0:0, 0:0, 0:0, 0:0,
0:0, 0:0, 0:0, 0:0, 0:0, 0:0, 0:0, 0:0, 0:0, 0:0, 0:0, 0:0, 0:0, 0:0, 0:0, 0:0,
0:0, 0:0, 0:0, 0:0, 0:0, 0:0, 0:0, 0:0, 0:0, 0:0, 0:0, 0:0, 0:0, 0:0, 0:0, 0:0,
8:8, 9:8, 0:0, 0:0, 5:1, 6:1, 7:1, 0:0, 0:0, 0:0, 0:0, 0:0, 0:0, 0:0, 0:0, 0:0,
0:0, 0:0, 0:0, 0:0, 0:0, 0:0, 0:0, 0:0, 0:0, 0:0, 0:0, 0:0, 0:0, 0:0, 0:0, 0:0,
0:0, 0:0, 0:0, 0:0, 0:0, 0:0, 0:0, 0:0, 0:0, 0:0, 0:0, 0:0, 0:0, 0:0, 0:0, 0:0,
0:0, 0:0, 0:0, 0:0, 0:0, 0:0, 0:0, 0:0, 0:0, 0:0, 0:0, 0:0, 0:0, 0:0, 0:0, 0:0,
0:0, 0:0, 0:0, 0:0, 0:0, 0:0, 0:0, 0:0, 0:0, 0:0, 0:0, 0:0, 0:0, 0:0, 0:0, 0:0,
8:9, 9:9, 0:0, 0:0, 0:0, 0:0, 0:0, 0:0, 0:0, 0:0, 0:0, 0:0, 0:0, 0:0, 0:0, 0:0,
0:0, 0:0, 0:0, 0:0, 0:0, 0:0, 0:0, 0:0, 0:0, 0:0, 0:0, 0:0, 0:0, 0:0, 0:0, 0:0,
0:0, 0:0, 0:0, 0:0, 0:0, 0:0, 0:0, 0:0, 0:6, 1:6, 2:6, 0:0, 0:0, 0:0, 0:0, 0:0,
0:0, 0:0, 0:0, 0:0, 0:0, 0:0, 0:0, 0:0, 0:0, 0:0, 0:0, 0:0, 0:0, 0:0, 0:0, 0:0,
0:0, 0:0, 0:0, 0:0, 0:0, 0:0, 0:0, 0:0, 0:0, 0:0, 0:0, 0:0, 0:0, 0:0, 0:0, 0:0,
8:8, 9:8, 0:0, 0:0, 0:0, 0:0, 0:0, 0:0, 0:0, 0:0, 0:0, 0:0, 0:0, 0:0, 0:0, 0:0,
0:0, 0:0, 0:0, 0:0, 0:0, 0:0, 0:0, 0:0, 0:0, 0:0, 0:0, 0:0, 0:0, 0:0, 0:0, 0:0,
0:0, 0:0, 0:0, 0:0, 0:0, 0:0, 0:0, 0:0, 0:7, 1:7, 2:7, 0:0, 0:0, 0:0, 0:0, 0:0,
0:0, 0:0, 0:0, 0:0, 0:0, 0:0, 0:0, 0:0, 0:0, 0:0, 0:0, 0:0, 0:0, 0:0, 0:0, 0:0,
0:0, 0:0, 0:0, 0:0, 0:0, 0:0, 0:0, 0:0, 0:0, 0:0, 0:0, 0:0, 0:0, 0:0, 0:0, 0:0,
8:9, 9:9, 0:0, 0:0, 0:0, 0:0, 0:0, 0:0, 0:0, 0:0, 0:0, 0:0, 0:0, 0:0, 0:0, 0:0,
0:0, 0:0, 0:0, 0:0, 0:0, 0:0, 0:0, 0:0, 0:0, 0:0, 0:0, 0:0, 0:0, 0:0, 0:0, 0:0,
0:0, 0:0, 0:0, 0:0, 0:0, 0:0, 0:6, 1:6, 2:6, 0:0, 0:0, 0:0, 0:0, 0:0, 0:0, 0:0,
0:0, 0:0, 0:0, 0:0, 0:0, 0:0, 0:0, 0:0, 0:0, 0:0, 0:0, 0:0, 0:0, 0:0, 0:0, 0:0,
0:0, 0:0, 0:0, 0:0, 0:0, 0:0, 0:0, 0:0, 0:0, 0:0, 0:0, 0:0, 0:0, 5:0, 6:0, 7:0,
8:8, 9:8, 0:0, 0:0, 0:0, 0:0, 0:0, 0:0, 0:0, 0:0, 0:0, 0:0, 13:1, 14:1, 15:1,
16:1, 17:1, 0:0, 0:0, 0:0, 0:0, 0:0, 0:0, 0:0, 0:0, 0:0, 0:0, 0:0, 0:0, 0:0,
0:0, 0:0, 0:0, 0:0, 0:0, 0:0, 0:0, 0:0, 0:7, 1:7, 2:7, 0:0, 0:0, 0:0, 0:0, 0:6,
1:6, 2:6, 0:0, 0:0, 0:0, 0:0, 0:0, 0:0, 0:0, 0:0, 0:0, 0:0, 0:0, 0:0, 0:0, 0:0,
0:0, 0:0, 0:0, 0:0, 0:0, 0:0, 0:0, 0:0, 0:0, 0:0, 0:0, 0:0, 0:0, 0:0, 0:0, 5:1,
6:1, 7:1, 8:9, 9:9, 0:0, 0:0, 0:0, 0:0, 0:0, 0:0, 0:0, 0:0, 0:0, 0:0, 13:2,
14:2, 15:2, 16:2, 17:2, 0:0, 0:0, 0:0, 0:0, 0:0, 0:0, 0:0, 0:0, 0:0, 0:0, 0:0,
0:0, 5:0, 6:0, 7:0, 0:0, 0:0, 0:0, 0:0, 0:0, 0:0, 0:0, 0:0, 0:6, 1:6, 2:6, 0:0,
0:0, 0:7, 1:7, 2:7, 0:0, 0:0, 0:0, 0:0, 0:0, 0:0, 0:0, 0:0, 0:0, 0:0, 0:0, 0:0,
0:6, 1:6, 2:6, 0:0, 0:0, 0:0, 0:0, 0:0, 0:0, 0:0, 0:0, 0:0, 0:0, 0:0, 0:0, 0:0,
0:0, 5:0, 6:0, 7:0, 8:8, 9:8, 0:0, 0:0, 0:0, 0:0, 0:0, 0:0, 0:0, 0:0, 0:0, 0:0,
13:3, 14:3, 15:3, 16:3, 17:3, 0:0, 0:0, 0:0, 0:0, 0:0, 0:0, 0:0, 0:0, 0:0, 0:0,
0:0, 0:0, 5:1, 6:1, 7:1, 0:0, 0:0, 0:0, 0:0, 0:0, 0:0, 0:0, 0:0, 0:7, 1:7, 2:7,
0:0, 0:0, 0:0, 0:0, 0:0, 0:0, 0:0, 0:0, 0:0, 0:0, 0:0, 0:0, 0:0, 0:0, 0:0, 0:0,
0:0, 0:7, 1:7, 2:7, 0:0, 0:0, 0:0, 0:0, 0:0, 0:0, 0:0, 0:0, 0:0, 0:0, 0:0, 0:0,
0:0, 0:0, 5:1, 6:1, 7:1, 8:9, 9:9, 0:0, 0:0, 0:0, 0:0, 0:0, 0:0, 0:0, 0:0, 0:0,
0:0, 0:0, 0:0, 0:0, 0:0, 0:0, 0:0, 0:0, 0:0, 0:0, 0:0, 0:0, 0:0, 0:0, 0:0, 0:0,
0:0, 0:0, 0:0, 0:0, 0:0, 0:0, 0:0, 0:0, 0:0, 0:0, 0:0, 0:6, 1:6, 2:6, 0:0, 0:0,
0:0, 0:0, 0:0, 0:0, 0:0, 0:0, 0:0, 0:0, 0:0, 0:0, 0:0, 0:0, 0:0, 0:0, 0:0, 0:0,
0:0, 0:0, 0:0, 0:0, 0:0, 0:0, 0:0, 0:0, 0:0, 0:0, 0:0, 0:0, 0:0, 0:0, 0:0, 0:0,
0:0, 0:0, 5:0, 6:0, 7:0, 8:8, 9:8, 0:0, 0:0, 0:0, 0:0, 0:0, 0:0, 0:0, 0:0, 0:0,
0:0, 0:0, 0:0, 0:0, 0:0, 0:0, 0:0, 0:0, 0:0, 0:0, 0:0, 0:0, 0:0, 0:0, 0:0, 0:0,
0:0, 0:0, 0:0, 0:0, 0:0, 0:0, 0:0, 0:0, 0:0, 0:0, 0:0, 0:7, 1:7, 2:7, 0:0, 0:0,
0:0, 0:0, 0:0, 0:0, 0:0, 0:0, 0:0, 0:0, 0:6, 1:6, 2:6, 0:0, 0:0, 0:0, 0:0, 0:0,
0:0, 0:0, 0:0, 0:0, 0:0, 0:0, 0:0, 0:0, 0:0, 0:0, 0:0, 0:0, 0:0, 0:0, 0:0, 0:0,
0:0, 0:0, 5:1, 6:1, 7:1, 8:9, 9:9, 0:0, 0:0, 0:0, 0:0, 0:0, 0:0, 0:0, 0:0, 0:0,
0:0, 0:0, 0:0, 0:0, 0:0, 0:0, 0:0, 0:0, 0:0, 0:0, 0:0, 0:0, 0:0, 0:0, 0:0, 0:0,
0:0, 0:0, 0:0, 0:0, 0:0, 0:0, 0:0, 0:0, 0:0, 0:0, 0:0, 0:0, 0:0, 0:6, 1:6, 2:6,
0:0, 0:0, 0:0, 0:0, 0:0, 0:0, 0:0, 0:0, 0:7, 1:7, 2:7, 0:0, 0:0, 0:0, 0:0, 0:0,
0:0, 0:0, 0:0, 0:0, 0:0, 0:0, 8:0, 9:0, 10:0, 11:0, 12:0, 0:0, 0:0, 0:0, 0:0,
0:0, 0:0, 0:0, 5:0, 6:0, 7:0, 8:8, 9:8, 0:0, 0:0, 0:0, 0:0, 0:0, 0:0, 0:0, 0:0,
0:0, 0:0, 0:0, 0:0, 0:0, 0:0, 0:0, 0:0, 0:0, 0:0, 0:0, 0:0, 5:0, 6:0, 7:0, 0:0,
0:0, 0:0, 0:0, 0:0, 0:0, 0:0, 0:0, 0:0, 0:0, 0:0, 0:0, 0:0, 0:0, 0:0, 0:7, 1:7,
2:7, 0:0, 0:0, 0:0, 0:0, 0:0, 0:0, 0:0, 0:0, 0:0, 0:0, 0:0, 0:0, 0:0, 0:0, 0:0,
0:0, 0:0, 0:0, 0:0, 0:0, 0:0, 0:0, 8:1, 9:1, 10:1, 11:1, 12:1, 0:0, 0:0, 0:0,
0:0, 0:0, 0:0, 0:0, 5:1, 6:1, 7:1, 8:9, 9:9, 0:0, 0:0, 0:0, 0:0, 0:0, 0:0, 0:0,
0:0, 0:0, 0:0, 0:0, 0:0, 0:0, 0:0, 0:0, 0:0, 0:0, 0:0, 0:0, 0:0, 5:1, 6:1, 7:1,
0:0, 0:0, 0:0, 0:0, 0:0, 0:0, 0:0, 0:0, 0:0, 0:0, 0:0, 0:0, 0:0, 5:0, 6:0, 7:0,
0:0, 0:0, 0:0, 0:0, 0:0, 0:0, 0:0, 0:0, 0:0, 0:0, 0:0, 0:0, 0:0, 0:0, 0:0, 0:0,
0:0, 0:0, 0:6, 1:6, 2:6, 0:0, 0:0, 0:0, 8:2, 9:2, 10:2, 11:2, 12:2, 0:0, 0:0,
0:0, 0:0, 0:0, 0:0, 0:0, 5:0, 6:0, 7:0, 8:8, 9:8, 0:0, 0:0, 0:0, 0:0, 0:0, 0:0,
0:0, 0:0, 0:0, 11:8, 12:8, 0:0, 0:0, 0:0, 0:0, 11:8, 12:8, 0:0, 0:0, 0:0, 0:0,
0:0, 0:0, 0:0, 0:0, 0:0, 0:0, 0:0, 0:0, 0:0, 0:0, 0:0, 0:0, 0:0, 0:0, 0:0, 5:1,
6:1, 7:1, 0:0, 0:0, 0:0, 0:0, 0:0, 0:0, 0:6, 1:6, 2:6, 0:0, 0:0, 0:0, 0:0, 0:0,
0:0, 0:0, 0:0, 0:0, 0:7, 1:7, 2:7, 0:0, 0:0, 0:0, 8:3, 9:3, 10:3, 11:3, 12:3,
0:0, 0:0, 0:0, 0:0, 0:0, 0:0, 0:0, 5:1, 6:1, 7:1, 8:9, 9:9, 0:0, 0:0, 0:0, 0:0,
0:0, 0:0, 0:0, 0:0, 0:0, 11:9, 0:0, 0:0, 0:0, 0:0, 0:0, 11:9, 0:0, 0:0, 0:0,
0:0, 0:0, 0:0, 0:0, 0:0, 0:0, 0:0, 0:0, 0:0, 0:0, 0:0, 0:0, 0:0, 0:0, 0:0, 0:0,
0:0, 0:0, 0:0, 0:0, 0:0, 0:0, 0:0, 0:0, 0:0, 0:0, 0:7, 1:7, 2:7, 0:0, 0:0, 0:0,
0:0, 0:0, 0:0, 0:0, 0:0, 0:0, 0:0, 0:0, 0:0, 0:0, 0:0, 0:0, 0:0, 0:0, 0:0, 0:0,
0:0, 0:0, 0:0, 0:0, 0:0, 0:0, 0:0, 0:0, 5:0, 6:0, 7:0, 8:8, 9:8, 0:0, 0:0, 5:0,
6:0, 7:0, 0:0, 0:0, 0:0, 0:0, 0:0, 0:0, 0:0, 0:0, 0:0, 0:0, 0:0, 0:0, 0:0, 0:0,
0:0, 0:0, 0:0, 0:0, 0:0, 0:0, 0:0, 0:0, 0:0, 0:0, 0:0, 0:0, 0:0, 0:0, 0:0, 0:0,
0:0, 0:0, 0:0, 0:0, 0:0, 0:0, 0:0, 0:0, 0:0, 0:0, 0:0, 0:0, 0:0, 0:0, 0:0, 0:0,
0:0, 0:0, 0:0, 0:0, 0:0, 0:0, 0:0, 0:0, 0:0, 0:0, 0:0, 0:0, 0:0, 0:0, 0:0, 0:0,
0:0, 0:0, 0:0, 0:0, 0:0, 0:0, 0:0, 0:0, 5:1, 6:1, 7:1, 8:9, 9:9, 0:0, 0:0, 5:1,
6:1, 7:1, 0:0, 0:0, 0:0, 0:0, 0:0, 0:0, 0:0, 0:0, 0:0, 0:0, 0:0, 0:0, 0:0, 0:0,
0:0, 0:0, 0:0, 0:0, 0:0, 0:0, 0:0, 0:0, 0:0, 0:0, 0:0, 0:0, 0:0, 0:0, 0:0, 0:0,
0:0, 0:0, 0:0, 0:0, 0:0, 0:0, 0:0, 0:0, 0:0, 0:0, 0:0, 0:0, 0:0, 0:0, 0:0, 0:6,
1:6, 2:6, 0:0, 0:0, 0:0, 0:0, 0:0, 0:0, 0:0, 11:8, 12:8, 0:0, 0:0, 0:0, 0:0,
0:0, 0:0, 0:0, 0:0, 0:0, 0:0, 0:0, 0:0, 0:0, 5:0, 6:0, 7:0, 8:8, 9:8, 0:0, 0:0,
0:0, 0:0, 0:0, 0:0, 0:0, 0:0, 0:0, 0:0, 0:0, 0:0, 0:0, 0:0, 0:0, 0:0, 0:0, 0:0,
0:0, 0:0, 0:0, 0:0, 0:0, 0:0, 0:0, 0:0, 0:0, 0:0, 0:0, 0:0, 0:0, 0:0, 0:0, 0:0,
0:0, 0:0, 0:0, 0:6, 1:6, 2:6, 0:0, 0:0, 0:0, 0:0, 0:0, 0:0, 0:0, 0:0, 0:0, 0:0,
0:7, 1:7, 2:7, 0:0, 0:0, 0:0, 0:0, 0:0, 0:0, 0:0, 11:9, 0:0, 0:0, 0:0, 0:0,
0:0, 10:8, 0:0, 0:0, 0:0, 0:0, 0:0, 0:0, 0:0, 0:0, 5:1, 6:1, 7:1, 8:9, 9:9,
0:0, 0:0, 5:0, 6:0, 7:0, 0:0, 0:0, 0:0, 0:0, 0:0, 0:0, 0:0, 0:0, 0:0, 0:0, 0:0,
0:0, 0:0, 0:0, 0:0, 0:0, 0:0, 0:0, 0:0, 0:0, 0:0, 0:0, 0:0, 0:0, 0:0, 0:0, 0:0,
0:0, 0:0, 0:0, 0:0, 0:0, 0:7, 1:7, 2:7, 0:0, 0:0, 0:0, 0:0, 0:0, 0:0, 0:0, 0:0,
0:0, 0:0, 0:0, 0:0, 0:0, 0:0, 0:0, 0:0, 0:0, 0:0, 0:0, 0:0, 0:0, 0:0, 0:0, 0:0,
0:0, 0:0, 0:0, 0:0, 0:0, 0:0, 0:0, 0:0, 0:0, 0:0, 0:0, 5:0, 6:0, 7:0, 8:8, 9:8,
0:0, 0:0, 5:1, 6:1, 7:1, 0:0, 0:0, 0:0, 0:0, 0:0, 0:0, 0:0, 0:0, 0:0, 0:0, 0:0,
0:0, 0:0, 0:0, 0:0, 0:0, 0:0, 0:0, 0:0, 0:0, 0:0, 5:0, 6:0, 7:0, 0:0, 0:0, 0:0,
0:0, 0:0, 0:0, 0:0, 0:6, 1:6, 2:6, 0:0, 0:0, 0:0, 0:0, 0:0, 0:0, 0:0, 0:0, 0:0,
0:0, 0:0, 0:0, 0:0, 0:0, 0:0, 0:0, 0:0, 0:0, 0:0, 0:0, 0:0, 0:0, 0:0, 0:0, 0:0,
0:0, 0:0, 0:0, 0:0, 0:0, 0:0, 0:0, 0:0, 0:0, 0:0, 0:0, 5:1, 6:1, 7:1, 8:9, 9:9,
0:0, 0:0, 0:0, 0:0, 0:0, 0:0, 0:0, 0:0, 0:0, 0:0, 0:0, 0:0, 0:0, 0:0, 0:0, 0:0,
0:0, 0:0, 0:0, 0:0, 0:0, 0:0, 0:0, 0:0, 0:0, 0:0, 5:1, 6:1, 7:1, 0:0, 0:0, 0:0,
0:0, 0:0, 0:0, 0:0, 0:7, 1:7, 2:7, 0:0, 0:0, 0:0, 0:0, 0:0, 0:0, 0:0, 0:0, 0:0,
0:0, 0:0, 0:0, 0:0, 0:0, 0:0, 0:0, 0:0, 0:0, 0:0, 0:0, 0:0, 0:0, 0:0, 0:0, 0:0,
0:0, 0:0, 0:0, 0:0, 0:0, 0:0, 0:0, 0:0, 0:0, 0:0, 0:0, 5:0, 6:0, 7:0, 8:8, 9:8,
0:0, 0:0, 5:0, 6:0, 7:0, 0:0, 0:0, 0:0, 0:0, 0:0, 0:0, 0:0, 0:0, 0:0, 0:0, 0:0,
0:0, 0:0, 0:0, 0:0, 0:0, 0:0, 0:0, 0:0, 0:0, 0:0, 0:0, 0:0, 0:0, 0:0, 0:0, 0:0,
0:0, 0:0, 0:0, 0:0, 0:6, 1:6, 2:6, 0:0, 0:0, 0:0, 0:0, 0:0, 0:0, 0:0, 0:0, 0:0,
0:0, 0:0, 0:0, 0:0, 0:0, 0:0, 0:0, 0:0, 0:0, 0:0, 0:0, 0:0, 0:0, 0:0, 0:0, 0:0,
0:0, 0:0, 0:0, 0:0, 0:0, 0:0, 0:0, 0:0, 0:0, 0:0, 0:0, 5:1, 6:1, 7:1, 8:9, 9:9,
0:0, 0:0, 5:1, 6:1, 7:1, 0:0, 0:0, 0:0, 0:0, 0:0, 0:0, 0:0, 0:0, 0:0, 0:0, 0:0,
0:0, 0:0, 0:0, 0:0, 0:0, 0:0, 0:0, 0:0, 0:0, 0:0, 0:0, 0:0, 0:0, 0:0, 0:0, 0:0,
0:0, 0:0, 0:0, 0:0, 0:7, 1:7, 2:7, 0:0, 0:0, 0:0, 0:0, 0:0, 0:0, 0:6, 1:6, 2:6,
0:0, 0:0, 0:0, 0:0, 0:0, 0:0, 0:0, 0:0, 0:0, 0:0, 0:0, 0:0, 0:0, 0:0, 0:0, 0:0,
0:0, 0:0, 0:0, 0:0, 0:0, 0:0, 0:0, 0:0, 0:0, 0:0, 0:0, 5:0, 6:0, 7:0, 8:8, 9:8,
0:0, 0:0, 0:0, 0:0, 0:0, 0:0, 0:0, 0:0, 0:0, 0:0, 0:0, 0:0, 0:0, 0:0, 0:0, 0:0,
0:0, 0:0, 0:0, 0:0, 0:0, 0:0, 0:0, 0:0, 0:0, 0:0, 0:0, 0:0, 0:0, 0:0, 0:0, 0:0,
0:0, 0:0, 0:0, 0:6, 1:6, 2:6, 0:0, 0:0, 0:0, 0:0, 0:0, 0:0, 0:0, 0:7, 1:7, 2:7,
0:0, 0:0, 0:0, 0:0, 0:0, 0:0, 0:0, 0:0, 0:0, 0:6, 1:6, 2:6, 0:0, 0:0, 0:0, 0:0,
0:0, 0:0, 0:0, 0:0, 0:0, 0:0, 0:0, 0:0, 0:0, 0:0, 0:0, 5:1, 6:1, 7:1, 8:9, 9:9,
0:0, 0:0, 5:0, 6:0, 7:0, 5:0, 6:0, 7:0, 5:0, 6:0, 7:0, 5:0, 6:0, 7:0, 5:0, 6:0,
7:0, 0:0, 0:0, 0:0, 0:0, 0:0, 0:0, 0:0, 0:0, 0:0, 0:0, 0:0, 0:0, 0:0, 0:0, 0:0,
0:0, 0:0, 0:0, 0:7, 1:7, 2:7, 0:0, 0:0, 0:0, 0:0, 0:0, 0:0, 0:0, 0:0, 0:0, 0:0,
0:0, 0:0, 0:0, 0:0, 0:0, 0:0, 0:0, 0:0, 0:0, 0:7, 1:7, 2:7, 0:0, 0:0, 0:0, 0:0,
0:0, 0:0, 0:0, 0:0, 0:0, 0:0, 0:0, 0:0, 0:0, 0:0, 0:0, 5:0, 6:0, 7:0, 8:8, 9:8,
0:0, 0:0, 5:1, 6:1, 7:1, 5:1, 6:1, 7:1, 5:1, 6:1, 7:1, 5:1, 6:1, 7:1, 5:1, 6:1,
7:1, 0:0, 0:0, 0:0, 0:0, 0:0, 0:0, 0:0, 0:0, 0:0, 0:0, 0:0, 0:0, 0:0, 0:0, 0:0,
0:0, 0:0, 0:0, 0:0, 0:6, 1:6, 2:6, 0:0, 0:0, 0:0, 0:0, 0:0, 0:0, 0:0, 0:0, 0:0,
0:0, 0:0, 0:0, 0:0, 0:0, 0:0, 0:0, 0:0, 0:0, 0:0, 0:0, 0:0, 0:0, 0:0, 0:0, 0:0,
0:0, 0:0, 0:0, 0:0, 0:0, 0:0, 0:0, 0:0, 0:0, 0:0, 0:0, 5:1, 6:1, 7:1, 8:9, 9:9,
0:0, 0:0, 0:0, 0:0, 0:0, 0:0, 0:0, 0:0, 0:0, 0:0, 0:0, 0:0, 0:0, 0:0, 0:0, 0:0,
0:0, 0:0, 0:0, 0:0, 0:0, 0:0, 0:0, 0:0, 0:0, 0:0, 0:0, 0:0, 0:0, 0:0, 0:0, 0:0,
0:0, 0:0, 0:0, 0:0, 0:7, 1:7, 2:7, 0:0, 0:0, 0:0, 0:0, 0:0, 0:0, 0:0, 0:0, 0:0,
0:0, 0:0, 0:0, 0:0, 0:0, 0:0, 0:0, 0:0, 0:0, 0:0, 0:0, 0:0, 0:0, 0:0, 0:0, 0:0,
0:0, 0:0, 0:0, 0:0, 0:0, 0:0, 0:0, 0:0, 0:0, 0:0, 0:0, 5:0, 6:0, 7:0, 8:8, 9:8,
0:0, 0:0, 0:0, 0:0, 0:0, 0:0, 0:0, 0:0, 0:0, 0:0, 0:0, 0:0, 0:0, 0:0, 0:0, 0:0,
0:0, 0:0, 0:0, 0:0, 0:0, 0:0, 0:0, 0:0, 0:0, 0:0, 0:0, 0:0, 0:0, 0:0, 0:0, 0:0,
0:0, 0:0, 0:0, 0:0, 0:0, 0:0, 0:0, 0:0, 0:0, 0:0, 0:0, 0:0, 0:0, 0:0, 0:0, 0:0,
0:0, 0:0, 0:0, 0:0, 0:0, 0:0, 0:0, 0:0, 0:0, 0:0, 0:0, 0:0, 0:0, 0:0, 0:0, 0:0,
0:0, 0:0, 0:0, 0:0, 0:0, 0:0, 0:0, 0:0, 0:0, 0:0, 0:0, 5:1, 6:1, 7:1, 8:9, 9:9,
5:0, 6:0, 7:0, 5:0, 6:0, 7:0, 5:0, 6:0, 7:0, 5:0, 6:0, 7:0, 5:0, 6:0, 7:0, 5:0,
6:0, 7:0, 5:0, 6:0, 7:0, 5:0, 6:0, 7:0, 5:0, 6:0, 7:0, 5:0, 6:0, 7:0, 5:0, 6:0,
7:0, 5:0, 6:0, 7:0, 5:0, 6:0, 7:0, 5:0, 6:0, 7:0, 5:0, 6:0, 7:0, 5:0, 6:0, 7:0,
5:0, 6:0, 7:0, 5:0, 6:0, 7:0, 5:0, 6:0, 7:0, 5:0, 6:0, 7:0, 5:0, 6:0, 7:0, 5:0,
6:0, 7:0, 5:0, 6:0, 7:0, 5:0, 6:0, 7:0, 5:0, 6:0, 7:0, 5:0, 6:0, 7:0, 8:8, 9:8,
5:1, 6:1, 7:1, 5:1, 6:1, 7:1, 5:1, 6:1, 7:1, 5:1, 6:1, 7:1, 5:1, 6:1, 7:1, 5:1,
6:1, 7:1, 5:1, 6:1, 7:1, 5:1, 6:1, 7:1, 5:1, 6:1, 7:1, 5:1, 6:1, 7:1, 5:1, 6:1,
7:1, 5:1, 6:1, 7:1, 5:1, 6:1, 7:1, 5:1, 6:1, 7:1, 5:1, 6:1, 7:1, 5:1, 6:1, 7:1,
5:1, 6:1, 7:1, 5:1, 6:1, 7:1, 5:1, 6:1, 7:1, 5:1, 6:1, 7:1, 5:1, 6:1, 7:1, 5:1,
6:1, 7:1, 5:1, 6:1, 7:1, 5:1, 6:1, 7:1, 5:1, 6:1, 7:1, 5:1, 6:1, 7:1, 8:9, 9:9,
0:0, 0:0, 0:0, 0:0, 0:0, 0:0, 0:0, 0:0, 0:0, 0:0, 0:0, 0:0, 0:0, 0:0, 0:0, 0:0,
0:0, 0:0, 0:0, 0:0, 0:0, 0:0, 0:0, 0:0, 0:0, 0:0, 0:0, 0:0, 0:0, 0:0, 0:0, 0:0,
0:0, 0:0, 0:0, 0:0, 0:0, 0:0, 0:0, 0:0, 0:0, 0:0, 0:0, 0:0, 0:0, 0:0, 0:0, 0:0,
0:0, 0:0, 0:0, 0:0, 0:0, 0:0, 0:0, 0:0, 0:0, 0:0, 0:0, 0:0, 0:0, 0:0, 0:0, 0:0,
0:0, 0:0, 0:0, 0:0, 0:0, 0:0, 0:0, 0:0, 0:0, 0:0, 0:0, 0:0, 0:0, 0:0, 0:0, 0:0,
0:0, 0:0, 0:0, 0:0, 0:0, 0:0, 0:0, 0:0, 0:0, 0:0, 0:0, 0:0, 0:0, 0:0, 0:0, 0:0,
0:0, 0:0, 0:0, 0:0, 0:0, 0:0, 0:0, 0:0, 0:0, 0:0, 0:0, 0:0, 0:0, 0:0, 0:0, 0:0,
0:0, 0:0, 0:0, 0:0, 0:0, 0:0, 0:0, 0:0, 0:0, 0:0, 0:0, 0:0, 0:0, 0:0, 0:0, 0:0,
0:0, 0:0, 0:0, 0:0, 0:0, 0:0, 0:0, 0:0, 0:0, 0:0, 0:0, 0:0, 0:0, 0:0, 0:0, 0:0,
0:0, 0:0, 0:0, 0:0, 0:0, 0:0, 0:0, 0:0, 0:0, 0:0, 0:0, 0:0, 0:0, 0:0
